"","區域名","里數","鄰數","戶數","人口數","男","女","年月","地區"
"1","高雄市","893","17785","1023188","2773433","1390604","1382829","100.1","高雄市"
"2","鹽埕區","21","237","11162","27371","13716","13655","100.1","高雄市"
"3","鼓山區","38","722","52305","131730","64571","67159","100.1","高雄市"
"4","左營區","40","747","73916","192040","94472","97568","100.1","高雄市"
"5","楠梓區","37","803","61951","173132","85862","87270","100.1","高雄市"
"6","三民一","41","670","33363","86567","43284","43283","100.1","高雄市"
"7","三民二","45","1074","98300","267106","129790","137316","100.1","高雄市"
"8","新興區","32","459","22935","55247","26892","28355","100.1","高雄市"
"9","前金區","20","264","12527","28837","14023","14814","100.1","高雄市"
"10","苓雅區","69","1248","71795","183742","89439","94303","100.1","高雄市"
"11","前鎮區","59","1298","76523","199015","98796","100219","100.1","高雄市"
"12","旗津區","13","213","10967","29972","15573","14399","100.1","高雄市"
"13","小港區","38","697","63330","154511","77614","76897","100.1","高雄市"
"14","鳳山一","43","1145","65534","175149","86802","88347","100.1","高雄市"
"15","鳳山二","35","992","61478","166384","83407","82977","100.1","高雄市"
"16","林園區","24","525","24136","70464","36183","34281","100.1","高雄市"
"17","大寮區","25","829","38326","108973","56563","52410","100.1","高雄市"
"18","大樹區","18","376","13054","43938","22729","21209","100.1","高雄市"
"19","大社區","9","175","11715","33008","16948","16060","100.1","高雄市"
"20","仁武區","16","392","26046","72453","37370","35083","100.1","高雄市"
"21","鳥松區","7","192","16553","42716","21700","21016","100.1","高雄市"
"22","岡山區","33","540","33190","97097","48747","48350","100.1","高雄市"
"23","橋頭區","17","359","12614","36473","18706","17767","100.1","高雄市"
"24","燕巢區","11","289","9984","30785","16407","14378","100.1","高雄市"
"25","田寮區","10","154","3551","8194","4553","3641","100.1","高雄市"
"26","阿蓮區","12","276","9154","30374","15326","15048","100.1","高雄市"
"27","路竹區","20","395","16045","53787","27418","26369","100.1","高雄市"
"28","湖內區","14","260","9545","28802","14828","13974","100.1","高雄市"
"29","茄萣區","15","341","10134","31425","16386","15039","100.1","高雄市"
"30","永安區","6","81","5842","14297","7267","7030","100.1","高雄市"
"31","彌陀區","12","227","6625","20427","10637","9790","100.1","高雄市"
"32","梓官區","15","286","12057","36722","19067","17655","100.1","高雄市"
"33","旗山區","21","382","13830","39876","20796","19080","100.1","高雄市"
"34","美濃區","19","389","14172","42931","22427","20504","100.1","高雄市"
"35","六龜區","12","222","5774","14811","8013","6798","100.1","高雄市"
"36","甲仙區","7","103","2512","7222","3881","3341","100.1","高雄市"
"37","杉林區","7","138","4401","11873","6476","5397","100.1","高雄市"
"38","內門區","18","207","5028","15920","8684","7236","100.1","高雄市"
"39","茂林區","3","19","574","1870","941","929","100.1","高雄市"
"40","桃源區","8","39","1357","4812","2555","2257","100.1","高雄市"
"41","那瑪夏區","3","20","883","3380","1755","1625","100.1","高雄市"
"42","高雄市","893","17785","1023848","2772929","1390167","1382762","100.2","高雄市"
"43","鹽埕區","21","237","11155","27353","13715","13638","100.2","高雄市"
"44","鼓山區","38","722","52314","131686","64538","67148","100.2","高雄市"
"45","左營區","40","747","73942","192068","94489","97579","100.2","高雄市"
"46","楠梓區","37","803","61998","173174","85893","87281","100.2","高雄市"
"47","三民一","41","670","33336","86457","43214","43243","100.2","高雄市"
"48","三民二","45","1074","98307","266895","129630","137265","100.2","高雄市"
"49","新興區","32","459","22911","55115","26816","28299","100.2","高雄市"
"50","前金區","20","264","12541","28788","13996","14792","100.2","高雄市"
"51","苓雅區","69","1248","71792","183529","89321","94208","100.2","高雄市"
"52","前鎮區","59","1298","76513","198843","98685","100158","100.2","高雄市"
"53","旗津區","13","213","10976","29959","15574","14385","100.2","高雄市"
"54","小港區","38","697","63391","154533","77631","76902","100.2","高雄市"
"55","鳳山一","43","1145","65610","175259","86834","88425","100.2","高雄市"
"56","鳳山二","35","992","61582","166596","83463","83133","100.2","高雄市"
"57","林園區","24","525","24163","70448","36165","34283","100.2","高雄市"
"58","大寮區","25","829","38382","109011","56599","52412","100.2","高雄市"
"59","大樹區","18","376","13065","43918","22719","21199","100.2","高雄市"
"60","大社區","9","175","11723","33052","16973","16079","100.2","高雄市"
"61","仁武區","16","392","26133","72665","37485","35180","100.2","高雄市"
"62","鳥松區","7","192","16561","42725","21702","21023","100.2","高雄市"
"63","岡山區","33","540","33231","97126","48750","48376","100.2","高雄市"
"64","橋頭區","17","359","12640","36503","18714","17789","100.2","高雄市"
"65","燕巢區","11","289","9991","30787","16414","14373","100.2","高雄市"
"66","田寮區","10","154","3551","8164","4540","3624","100.2","高雄市"
"67","阿蓮區","12","276","9162","30364","15315","15049","100.2","高雄市"
"68","路竹區","20","395","16058","53764","27394","26370","100.2","高雄市"
"69","湖內區","14","260","9570","28780","14821","13959","100.2","高雄市"
"70","茄萣區","15","341","10137","31389","16374","15015","100.2","高雄市"
"71","永安區","6","81","5845","14279","7262","7017","100.2","高雄市"
"72","彌陀區","12","227","6634","20438","10627","9811","100.2","高雄市"
"73","梓官區","15","286","12057","36662","19046","17616","100.2","高雄市"
"74","旗山區","21","382","13848","39878","20797","19081","100.2","高雄市"
"75","美濃區","19","389","14186","42916","22428","20488","100.2","高雄市"
"76","六龜區","12","222","5769","14761","7982","6779","100.2","高雄市"
"77","甲仙區","7","103","2508","7201","3867","3334","100.2","高雄市"
"78","杉林區","7","138","4419","11903","6492","5411","100.2","高雄市"
"79","內門區","18","207","5030","15901","8667","7234","100.2","高雄市"
"80","茂林區","3","19","577","1870","940","930","100.2","高雄市"
"81","桃源區","8","39","1360","4801","2548","2253","100.2","高雄市"
"82","那瑪夏區","3","20","880","3368","1747","1621","100.2","高雄市"
"83","高雄市","893","17785","1025181","2772834","1389882","1382952","100.3","高雄市"
"84","鹽埕區","21","237","11164","27343","13707","13636","100.3","高雄市"
"85","鼓山區","38","722","52386","131768","64574","67194","100.3","高雄市"
"86","左營區","40","747","74030","192216","94544","97672","100.3","高雄市"
"87","楠梓區","37","803","62039","173221","85905","87316","100.3","高雄市"
"88","三民一","41","670","33312","86277","43091","43186","100.3","高雄市"
"89","三民二","45","1074","98439","266820","129612","137208","100.3","高雄市"
"90","新興區","32","459","22895","55017","26747","28270","100.3","高雄市"
"91","前金區","20","264","12540","28719","13963","14756","100.3","高雄市"
"92","苓雅區","69","1248","71848","183244","89184","94060","100.3","高雄市"
"93","前鎮區","59","1298","76610","198726","98620","100106","100.3","高雄市"
"94","旗津區","13","213","10983","29915","15545","14370","100.3","高雄市"
"95","小港區","38","697","63413","154458","77596","76862","100.3","高雄市"
"96","鳳山一","43","1145","65755","175377","86860","88517","100.3","高雄市"
"97","鳳山二","35","992","61765","166873","83582","83291","100.3","高雄市"
"98","林園區","24","525","24162","70430","36135","34295","100.3","高雄市"
"99","大寮區","25","829","38462","109108","56661","52447","100.3","高雄市"
"100","大樹區","18","376","13080","43899","22699","21200","100.3","高雄市"
"101","大社區","9","175","11741","33091","16984","16107","100.3","高雄市"
"102","仁武區","16","392","26241","72962","37605","35357","100.3","高雄市"
"103","鳥松區","7","192","16642","42797","21736","21061","100.3","高雄市"
"104","岡山區","33","540","33276","97120","48755","48365","100.3","高雄市"
"105","橋頭區","17","359","12676","36551","18739","17812","100.3","高雄市"
"106","燕巢區","11","289","10014","30830","16429","14401","100.3","高雄市"
"107","田寮區","10","154","3545","8143","4534","3609","100.3","高雄市"
"108","阿蓮區","12","276","9169","30357","15297","15060","100.3","高雄市"
"109","路竹區","20","395","16083","53702","27375","26327","100.3","高雄市"
"110","湖內區","14","260","9593","28795","14821","13974","100.3","高雄市"
"111","茄萣區","15","341","10147","31359","16350","15009","100.3","高雄市"
"112","永安區","6","81","5845","14247","7239","7008","100.3","高雄市"
"113","彌陀區","12","227","6636","20382","10596","9786","100.3","高雄市"
"114","梓官區","15","286","12086","36695","19056","17639","100.3","高雄市"
"115","旗山區","21","382","13853","39847","20776","19071","100.3","高雄市"
"116","美濃區","19","389","14194","42869","22382","20487","100.3","高雄市"
"117","六龜區","12","222","5767","14698","7955","6743","100.3","高雄市"
"118","甲仙區","7","103","2511","7165","3845","3320","100.3","高雄市"
"119","杉林區","7","138","4433","11909","6500","5409","100.3","高雄市"
"120","內門區","18","207","5026","15866","8651","7215","100.3","高雄市"
"121","茂林區","3","19","575","1859","934","925","100.3","高雄市"
"122","桃源區","8","39","1363","4808","2556","2252","100.3","高雄市"
"123","那瑪夏區","3","20","882","3371","1742","1629","100.3","高雄市"
"124","高雄市","893","17785","1026340","2772981","1389663","1383318","100.4","高雄市"
"125","鹽埕區","21","237","11172","27291","13668","13623","100.4","高雄市"
"126","鼓山區","38","722","52459","131736","64508","67228","100.4","高雄市"
"127","左營區","40","747","74161","192323","94571","97752","100.4","高雄市"
"128","楠梓區","37","803","62081","173288","85948","87340","100.4","高雄市"
"129","三民一","41","670","33306","86195","43057","43138","100.4","高雄市"
"130","三民二","45","1074","98583","266874","129586","137288","100.4","高雄市"
"131","新興區","32","459","22880","54984","26727","28257","100.4","高雄市"
"132","前金區","20","264","12545","28702","13947","14755","100.4","高雄市"
"133","苓雅區","69","1248","71871","183097","89109","93988","100.4","高雄市"
"134","前鎮區","59","1298","76668","198621","98540","100081","100.4","高雄市"
"135","旗津區","13","213","10991","29887","15540","14347","100.4","高雄市"
"136","小港區","38","697","63470","154404","77562","76842","100.4","高雄市"
"137","鳳山一","43","1145","65834","175577","86900","88677","100.4","高雄市"
"138","鳳山二","35","992","61872","167224","83701","83523","100.4","高雄市"
"139","林園區","24","525","24173","70401","36121","34280","100.4","高雄市"
"140","大寮區","25","829","38511","109066","56645","52421","100.4","高雄市"
"141","大樹區","18","376","13085","43864","22672","21192","100.4","高雄市"
"142","大社區","9","175","11770","33091","16991","16100","100.4","高雄市"
"143","仁武區","16","392","26351","73175","37716","35459","100.4","高雄市"
"144","鳥松區","7","192","16682","42791","21726","21065","100.4","高雄市"
"145","岡山區","33","540","33323","97183","48798","48385","100.4","高雄市"
"146","橋頭區","17","359","12714","36645","18769","17876","100.4","高雄市"
"147","燕巢區","11","289","10034","30837","16442","14395","100.4","高雄市"
"148","田寮區","10","154","3543","8129","4527","3602","100.4","高雄市"
"149","阿蓮區","12","276","9185","30331","15290","15041","100.4","高雄市"
"150","路竹區","20","395","16101","53696","27362","26334","100.4","高雄市"
"151","湖內區","14","260","9609","28785","14814","13971","100.4","高雄市"
"152","茄萣區","15","341","10148","31309","16320","14989","100.4","高雄市"
"153","永安區","6","81","5846","14223","7237","6986","100.4","高雄市"
"154","彌陀區","12","227","6639","20356","10576","9780","100.4","高雄市"
"155","梓官區","15","286","12103","36652","19046","17606","100.4","高雄市"
"156","旗山區","21","382","13857","39823","20750","19073","100.4","高雄市"
"157","美濃區","19","389","14203","42831","22360","20471","100.4","高雄市"
"158","六龜區","12","222","5769","14653","7929","6724","100.4","高雄市"
"159","甲仙區","7","103","2507","7140","3830","3310","100.4","高雄市"
"160","杉林區","7","138","4442","11930","6510","5420","100.4","高雄市"
"161","內門區","18","207","5031","15842","8642","7200","100.4","高雄市"
"162","茂林區","3","19","577","1853","930","923","100.4","高雄市"
"163","桃源區","8","39","1361","4810","2558","2252","100.4","高雄市"
"164","那瑪夏區","3","20","883","3362","1738","1624","100.4","高雄市"
"165","高雄市","893","17785","1027870","2772850","1389423","1383427","100.5","高雄市"
"166","鹽埕區","21","237","11168","27249","13646","13603","100.5","高雄市"
"167","鼓山區","38","722","52566","131844","64548","67296","100.5","高雄市"
"168","左營區","40","747","74330","192466","94602","97864","100.5","高雄市"
"169","楠梓區","37","803","62201","173463","86015","87448","100.5","高雄市"
"170","三民一","41","670","33287","85993","42957","43036","100.5","高雄市"
"171","三民二","45","1074","98717","266840","129584","137256","100.5","高雄市"
"172","新興區","32","459","22872","54880","26681","28199","100.5","高雄市"
"173","前金區","20","264","12539","28657","13925","14732","100.5","高雄市"
"174","苓雅區","69","1248","71878","182840","88952","93888","100.5","高雄市"
"175","前鎮區","59","1298","76693","198453","98463","99990","100.5","高雄市"
"176","旗津區","13","213","10983","29844","15518","14326","100.5","高雄市"
"177","小港區","38","697","63621","154511","77606","76905","100.5","高雄市"
"178","鳳山一","43","1145","66025","175677","86905","88772","100.5","高雄市"
"179","鳳山二","35","992","61993","167319","83714","83605","100.5","高雄市"
"180","林園區","24","525","24195","70378","36102","34276","100.5","高雄市"
"181","大寮區","25","829","38588","109072","56661","52411","100.5","高雄市"
"182","大樹區","18","376","13096","43823","22656","21167","100.5","高雄市"
"183","大社區","9","175","11798","33129","17019","16110","100.5","高雄市"
"184","仁武區","16","392","26461","73393","37831","35562","100.5","高雄市"
"185","鳥松區","7","192","16725","42910","21765","21145","100.5","高雄市"
"186","岡山區","33","540","33348","97148","48752","48396","100.5","高雄市"
"187","橋頭區","17","359","12773","36661","18769","17892","100.5","高雄市"
"188","燕巢區","11","289","10060","30841","16457","14384","100.5","高雄市"
"189","田寮區","10","154","3535","8113","4516","3597","100.5","高雄市"
"190","阿蓮區","12","276","9199","30308","15293","15015","100.5","高雄市"
"191","路竹區","20","395","16124","53681","27344","26337","100.5","高雄市"
"192","湖內區","14","260","9627","28795","14830","13965","100.5","高雄市"
"193","茄萣區","15","341","10158","31267","16296","14971","100.5","高雄市"
"194","永安區","6","81","5845","14221","7238","6983","100.5","高雄市"
"195","彌陀區","12","227","6657","20316","10553","9763","100.5","高雄市"
"196","梓官區","15","286","12133","36656","19043","17613","100.5","高雄市"
"197","旗山區","21","382","13859","39808","20726","19082","100.5","高雄市"
"198","美濃區","19","389","14223","42811","22352","20459","100.5","高雄市"
"199","六龜區","12","222","5774","14644","7932","6712","100.5","高雄市"
"200","甲仙區","7","103","2509","7118","3821","3297","100.5","高雄市"
"201","杉林區","7","138","4452","11925","6516","5409","100.5","高雄市"
"202","內門區","18","207","5034","15804","8628","7176","100.5","高雄市"
"203","茂林區","3","19","575","1847","926","921","100.5","高雄市"
"204","桃源區","8","39","1365","4787","2541","2246","100.5","高雄市"
"205","那瑪夏區","3","20","884","3358","1740","1618","100.5","高雄市"
"206","高雄市","893","17785","1029122","2772461","1388972","1383489","100.6","高雄市"
"207","鹽埕區","21","237","11142","27125","13588","13537","100.6","高雄市"
"208","鼓山區","38","722","52648","131966","64556","67410","100.6","高雄市"
"209","左營區","40","747","74451","192678","94687","97991","100.6","高雄市"
"210","楠梓區","37","803","62247","173457","85997","87460","100.6","高雄市"
"211","三民一","41","670","33300","85898","42879","43019","100.6","高雄市"
"212","三民二","45","1074","98861","266831","129552","137279","100.6","高雄市"
"213","新興區","32","459","22861","54816","26639","28177","100.6","高雄市"
"214","前金區","20","264","12532","28584","13880","14704","100.6","高雄市"
"215","苓雅區","69","1248","71902","182658","88834","93824","100.6","高雄市"
"216","前鎮區","59","1298","76749","198206","98365","99841","100.6","高雄市"
"217","旗津區","13","213","10987","29821","15498","14323","100.6","高雄市"
"218","小港區","38","697","63808","154629","77634","76995","100.6","高雄市"
"219","鳳山一","43","1145","66175","175804","86952","88852","100.6","高雄市"
"220","鳳山二","35","992","62089","167525","83825","83700","100.6","高雄市"
"221","林園區","24","525","24241","70283","36037","34246","100.6","高雄市"
"222","大寮區","25","829","38652","109024","56626","52398","100.6","高雄市"
"223","大樹區","18","376","13097","43771","22625","21146","100.6","高雄市"
"224","大社區","9","175","11811","33140","17029","16111","100.6","高雄市"
"225","仁武區","16","392","26573","73686","37982","35704","100.6","高雄市"
"226","鳥松區","7","192","16751","42946","21782","21164","100.6","高雄市"
"227","岡山區","33","540","33397","97097","48713","48384","100.6","高雄市"
"228","橋頭區","17","359","12810","36726","18795","17931","100.6","高雄市"
"229","燕巢區","11","289","10066","30858","16473","14385","100.6","高雄市"
"230","田寮區","10","154","3531","8097","4504","3593","100.6","高雄市"
"231","阿蓮區","12","276","9197","30279","15277","15002","100.6","高雄市"
"232","路竹區","20","395","16139","53619","27323","26296","100.6","高雄市"
"233","湖內區","14","260","9639","28758","14812","13946","100.6","高雄市"
"234","茄萣區","15","341","10164","31158","16246","14912","100.6","高雄市"
"235","永安區","6","81","5838","14211","7230","6981","100.6","高雄市"
"236","彌陀區","12","227","6654","20302","10537","9765","100.6","高雄市"
"237","梓官區","15","286","12141","36641","19046","17595","100.6","高雄市"
"238","旗山區","21","382","13848","39767","20697","19070","100.6","高雄市"
"239","美濃區","19","389","14235","42757","22320","20437","100.6","高雄市"
"240","六龜區","12","222","5774","14612","7913","6699","100.6","高雄市"
"241","甲仙區","7","103","2505","7089","3809","3280","100.6","高雄市"
"242","杉林區","7","138","4454","11932","6517","5415","100.6","高雄市"
"243","內門區","18","207","5036","15758","8608","7150","100.6","高雄市"
"244","茂林區","3","19","575","1848","930","918","100.6","高雄市"
"245","桃源區","8","39","1360","4761","2521","2240","100.6","高雄市"
"246","那瑪夏區","3","20","882","3343","1734","1609","100.6","高雄市"
"247","高雄市","893","17785","1030368","2772647","1388859","1383788","100.7","高雄市"
"248","鹽埕區","21","237","11145","27071","13564","13507","100.7","高雄市"
"249","鼓山區","38","722","52761","132183","64615","67568","100.7","高雄市"
"250","左營區","40","747","74541","192866","94756","98110","100.7","高雄市"
"251","楠梓區","37","803","62329","173472","86006","87466","100.7","高雄市"
"252","三民一","41","670","33297","85708","42795","42913","100.7","高雄市"
"253","三民二","45","1074","98995","266854","129585","137269","100.7","高雄市"
"254","新興區","32","459","22841","54742","26576","28166","100.7","高雄市"
"255","前金區","20","264","12542","28513","13867","14646","100.7","高雄市"
"256","苓雅區","69","1248","71901","182375","88674","93701","100.7","高雄市"
"257","前鎮區","59","1298","76790","198138","98327","99811","100.7","高雄市"
"258","旗津區","13","213","10984","29810","15472","14338","100.7","高雄市"
"259","小港區","38","697","63879","154537","77575","76962","100.7","高雄市"
"260","鳳山一","43","1145","66340","176024","87052","88972","100.7","高雄市"
"261","鳳山二","35","992","62220","167833","83946","83887","100.7","高雄市"
"262","林園區","24","525","24262","70228","36008","34220","100.7","高雄市"
"263","大寮區","25","829","38717","109104","56639","52465","100.7","高雄市"
"264","大樹區","18","376","13100","43685","22571","21114","100.7","高雄市"
"265","大社區","9","175","11838","33150","17027","16123","100.7","高雄市"
"266","仁武區","16","392","26662","73863","38083","35780","100.7","高雄市"
"267","鳥松區","7","192","16777","42976","21804","21172","100.7","高雄市"
"268","岡山區","33","540","33467","97165","48749","48416","100.7","高雄市"
"269","橋頭區","17","359","12834","36791","18828","17963","100.7","高雄市"
"270","燕巢區","11","289","10093","30920","16498","14422","100.7","高雄市"
"271","田寮區","10","154","3527","8093","4499","3594","100.7","高雄市"
"272","阿蓮區","12","276","9206","30265","15263","15002","100.7","高雄市"
"273","路竹區","20","395","16164","53615","27334","26281","100.7","高雄市"
"274","湖內區","14","260","9658","28762","14803","13959","100.7","高雄市"
"275","茄萣區","15","341","10168","31119","16226","14893","100.7","高雄市"
"276","永安區","6","81","5834","14165","7203","6962","100.7","高雄市"
"277","彌陀區","12","227","6651","20299","10534","9765","100.7","高雄市"
"278","梓官區","15","286","12128","36587","19010","17577","100.7","高雄市"
"279","旗山區","21","382","13860","39737","20670","19067","100.7","高雄市"
"280","美濃區","19","389","14262","42760","22336","20424","100.7","高雄市"
"281","六龜區","12","222","5775","14571","7892","6679","100.7","高雄市"
"282","甲仙區","7","103","2502","7079","3800","3279","100.7","高雄市"
"283","杉林區","7","138","4460","11921","6505","5416","100.7","高雄市"
"284","內門區","18","207","5042","15726","8591","7135","100.7","高雄市"
"285","茂林區","3","19","574","1850","930","920","100.7","高雄市"
"286","桃源區","8","39","1361","4758","2517","2241","100.7","高雄市"
"287","那瑪夏區","3","20","881","3332","1729","1603","100.7","高雄市"
"288","高雄市","893","17722","1031840","2772838","1388742","1384096","100.8","高雄市"
"289","鹽埕區","21","237","11139","26986","13513","13473","100.8","高雄市"
"290","鼓山區","38","722","52905","132393","64690","67703","100.8","高雄市"
"291","左營區","40","747","74635","192973","94771","98202","100.8","高雄市"
"292","楠梓區","37","803","62414","173477","85986","87491","100.8","高雄市"
"293","三民一","41","662","33318","85601","42735","42866","100.8","高雄市"
"294","三民二","45","1082","99131","266794","129614","137180","100.8","高雄市"
"295","新興區","32","456","22851","54663","26521","28142","100.8","高雄市"
"296","前金區","20","263","12547","28480","13864","14616","100.8","高雄市"
"297","苓雅區","69","1248","71962","182195","88552","93643","100.8","高雄市"
"298","前鎮區","59","1298","76815","197991","98230","99761","100.8","高雄市"
"299","旗津區","13","212","10986","29768","15469","14299","100.8","高雄市"
"300","小港區","38","697","63930","154472","77531","76941","100.8","高雄市"
"301","鳳山一","43","1113","66485","176180","87118","89062","100.8","高雄市"
"302","鳳山二","35","1007","62351","168089","84078","84011","100.8","高雄市"
"303","林園區","24","521","24342","70292","36044","34248","100.8","高雄市"
"304","大寮區","25","798","38766","109108","56620","52488","100.8","高雄市"
"305","大樹區","18","376","13113","43701","22583","21118","100.8","高雄市"
"306","大社區","9","175","11869","33202","17036","16166","100.8","高雄市"
"307","仁武區","16","390","26802","74123","38213","35910","100.8","高雄市"
"308","鳥松區","7","192","16828","43092","21845","21247","100.8","高雄市"
"309","岡山區","33","540","33500","97216","48750","48466","100.8","高雄市"
"310","橋頭區","17","359","12867","36805","18834","17971","100.8","高雄市"
"311","燕巢區","11","289","10125","30901","16505","14396","100.8","高雄市"
"312","田寮區","10","154","3524","8082","4487","3595","100.8","高雄市"
"313","阿蓮區","12","276","9207","30235","15251","14984","100.8","高雄市"
"314","路竹區","20","395","16173","53572","27319","26253","100.8","高雄市"
"315","湖內區","14","260","9680","28769","14798","13971","100.8","高雄市"
"316","茄萣區","15","339","10173","31090","16195","14895","100.8","高雄市"
"317","永安區","6","81","5829","14159","7201","6958","100.8","高雄市"
"318","彌陀區","12","227","6666","20297","10528","9769","100.8","高雄市"
"319","梓官區","15","286","12128","36604","19016","17588","100.8","高雄市"
"320","旗山區","21","381","13866","39637","20617","19020","100.8","高雄市"
"321","美濃區","19","389","14299","42759","22335","20424","100.8","高雄市"
"322","六龜區","12","221","5785","14546","7874","6672","100.8","高雄市"
"323","甲仙區","7","103","2505","7066","3786","3280","100.8","高雄市"
"324","杉林區","7","138","4458","11919","6506","5413","100.8","高雄市"
"325","內門區","18","207","5046","15705","8571","7134","100.8","高雄市"
"326","茂林區","3","19","576","1838","927","911","100.8","高雄市"
"327","桃源區","8","39","1361","4739","2509","2230","100.8","高雄市"
"328","那瑪夏區","3","20","883","3319","1720","1599","100.8","高雄市"
"329","高雄市","893","17670","1033956","2773157","1388639","1384518","100.9","高雄市"
"330","鹽埕區","21","237","11095","26815","13436","13379","100.9","高雄市"
"331","鼓山區","38","722","53086","132531","64755","67776","100.9","高雄市"
"332","左營區","40","747","74887","193189","94860","98329","100.9","高雄市"
"333","楠梓區","37","803","62573","173679","86088","87591","100.9","高雄市"
"334","三民一","41","662","33339","85443","42618","42825","100.9","高雄市"
"335","三民二","45","1082","99338","266800","129610","137190","100.9","高雄市"
"336","新興區","32","456","22879","54543","26444","28099","100.9","高雄市"
"337","前金區","20","263","12563","28469","13865","14604","100.9","高雄市"
"338","苓雅區","69","1248","72031","181965","88420","93545","100.9","高雄市"
"339","前鎮區","59","1298","76964","197956","98182","99774","100.9","高雄市"
"340","旗津區","13","212","10985","29799","15470","14329","100.9","高雄市"
"341","小港區","38","697","64081","154528","77581","76947","100.9","高雄市"
"342","鳳山一","43","1113","66618","176249","87096","89153","100.9","高雄市"
"343","鳳山二","35","1007","62521","168285","84147","84138","100.9","高雄市"
"344","林園區","24","521","24476","70340","36051","34289","100.9","高雄市"
"345","大寮區","25","747","38850","109115","56613","52502","100.9","高雄市"
"346","大樹區","18","376","13128","43696","22584","21112","100.9","高雄市"
"347","大社區","9","175","11888","33228","17036","16192","100.9","高雄市"
"348","仁武區","16","389","26952","74417","38374","36043","100.9","高雄市"
"349","鳥松區","7","192","16886","43132","21858","21274","100.9","高雄市"
"350","岡山區","33","540","33557","97245","48726","48519","100.9","高雄市"
"351","橋頭區","17","359","12867","36779","18816","17963","100.9","高雄市"
"352","燕巢區","11","289","10141","30900","16510","14390","100.9","高雄市"
"353","田寮區","10","154","3524","8066","4479","3587","100.9","高雄市"
"354","阿蓮區","12","276","9218","30224","15257","14967","100.9","高雄市"
"355","路竹區","20","395","16163","53489","27280","26209","100.9","高雄市"
"356","湖內區","14","260","9736","28848","14834","14014","100.9","高雄市"
"357","茄萣區","15","339","10182","31062","16178","14884","100.9","高雄市"
"358","永安區","6","81","5826","14118","7176","6942","100.9","高雄市"
"359","彌陀區","12","227","6670","20277","10517","9760","100.9","高雄市"
"360","梓官區","15","286","12125","36574","19011","17563","100.9","高雄市"
"361","旗山區","21","381","13869","39552","20573","18979","100.9","高雄市"
"362","美濃區","19","389","14306","42748","22328","20420","100.9","高雄市"
"363","六龜區","12","221","5790","14554","7881","6673","100.9","高雄市"
"364","甲仙區","7","103","2509","7042","3776","3266","100.9","高雄市"
"365","杉林區","7","138","4461","11911","6500","5411","100.9","高雄市"
"366","內門區","18","207","5043","15704","8568","7136","100.9","高雄市"
"367","茂林區","3","19","577","1835","920","915","100.9","高雄市"
"368","桃源區","8","39","1366","4740","2505","2235","100.9","高雄市"
"369","那瑪夏區","3","20","886","3310","1716","1594","100.9","高雄市"
"370","高雄市","893","17670","1034299","2773526","1388598","1384928","100.10","高雄市"
"371","鹽埕區","21","237","11069","26753","13402","13351","100.10","高雄市"
"372","鼓山區","38","722","53101","132629","64816","67813","100.10","高雄市"
"373","左營區","40","747","74862","193269","94873","98396","100.10","高雄市"
"374","楠梓區","37","803","62610","173790","86128","87662","100.10","高雄市"
"375","三民一","41","662","33329","85329","42570","42759","100.10","高雄市"
"376","三民二","45","1082","99333","266787","129570","137217","100.10","高雄市"
"377","新興區","32","456","22836","54445","26406","28039","100.10","高雄市"
"378","前金區","20","263","12545","28453","13857","14596","100.10","高雄市"
"379","苓雅區","69","1248","72018","181852","88380","93472","100.10","高雄市"
"380","前鎮區","59","1298","76950","197855","98118","99737","100.10","高雄市"
"381","旗津區","13","212","10992","29791","15451","14340","100.10","高雄市"
"382","小港區","38","697","64151","154651","77609","77042","100.10","高雄市"
"383","鳳山一","43","1113","66643","176383","87106","89277","100.10","高雄市"
"384","鳳山二","35","1007","62557","168389","84195","84194","100.10","高雄市"
"385","林園區","24","521","24529","70375","36063","34312","100.10","高雄市"
"386","大寮區","25","747","38907","109181","56662","52519","100.10","高雄市"
"387","大樹區","18","376","13127","43675","22549","21126","100.10","高雄市"
"388","大社區","9","175","11891","33258","17048","16210","100.10","高雄市"
"389","仁武區","16","389","27044","74645","38488","36157","100.10","高雄市"
"390","鳥松區","7","192","16891","43144","21866","21278","100.10","高雄市"
"391","岡山區","33","540","33583","97304","48732","48572","100.10","高雄市"
"392","橋頭區","17","359","12874","36774","18816","17958","100.10","高雄市"
"393","燕巢區","11","289","10123","30896","16489","14407","100.10","高雄市"
"394","田寮區","10","154","3522","8055","4470","3585","100.10","高雄市"
"395","阿蓮區","12","276","9216","30197","15245","14952","100.10","高雄市"
"396","路竹區","20","395","16165","53482","27278","26204","100.10","高雄市"
"397","湖內區","14","260","9749","28841","14836","14005","100.10","高雄市"
"398","茄萣區","15","339","10179","31033","16149","14884","100.10","高雄市"
"399","永安區","6","81","5817","14119","7175","6944","100.10","高雄市"
"400","彌陀區","12","227","6677","20260","10516","9744","100.10","高雄市"
"401","梓官區","15","286","12144","36601","19019","17582","100.10","高雄市"
"402","旗山區","21","381","13859","39502","20551","18951","100.10","高雄市"
"403","美濃區","19","389","14312","42712","22310","20402","100.10","高雄市"
"404","六龜區","12","221","5760","14476","7827","6649","100.10","高雄市"
"405","甲仙區","7","103","2498","7008","3758","3250","100.10","高雄市"
"406","杉林區","7","138","4558","12077","6592","5485","100.10","高雄市"
"407","內門區","18","207","5051","15703","8565","7138","100.10","高雄市"
"408","茂林區","3","19","576","1833","919","914","100.10","高雄市"
"409","桃源區","8","39","1368","4719","2493","2226","100.10","高雄市"
"410","那瑪夏區","3","20","883","3280","1701","1579","100.10","高雄市"
"411","高雄市","893","17670","1034753","2773855","1388493","1385362","100.11","高雄市"
"412","鹽埕區","21","237","11054","26722","13383","13339","100.11","高雄市"
"413","鼓山區","38","722","53137","132743","64845","67898","100.11","高雄市"
"414","左營區","40","747","74881","193335","94872","98463","100.11","高雄市"
"415","楠梓區","37","803","62617","173831","86135","87696","100.11","高雄市"
"416","三民一","41","662","33278","85256","42522","42734","100.11","高雄市"
"417","三民二","45","1082","99394","266868","129602","137266","100.11","高雄市"
"418","新興區","32","456","22821","54395","26366","28029","100.11","高雄市"
"419","前金區","20","263","12525","28469","13859","14610","100.11","高雄市"
"420","苓雅區","69","1248","71985","181720","88279","93441","100.11","高雄市"
"421","前鎮區","59","1298","76947","197772","98099","99673","100.11","高雄市"
"422","旗津區","13","212","10995","29786","15433","14353","100.11","高雄市"
"423","小港區","38","697","64227","154717","77622","77095","100.11","高雄市"
"424","鳳山一","43","1113","66720","176480","87137","89343","100.11","高雄市"
"425","鳳山二","35","1007","62567","168481","84229","84252","100.11","高雄市"
"426","林園區","24","521","24589","70440","36074","34366","100.11","高雄市"
"427","大寮區","25","747","38937","109169","56618","52551","100.11","高雄市"
"428","大樹區","18","376","13139","43646","22534","21112","100.11","高雄市"
"429","大社區","9","175","11906","33291","17061","16230","100.11","高雄市"
"430","仁武區","16","389","27133","74787","38556","36231","100.11","高雄市"
"431","鳥松區","7","192","16899","43166","21874","21292","100.11","高雄市"
"432","岡山區","33","540","33612","97364","48764","48600","100.11","高雄市"
"433","橋頭區","17","359","12880","36771","18819","17952","100.11","高雄市"
"434","燕巢區","11","289","10130","30935","16507","14428","100.11","高雄市"
"435","田寮區","10","154","3521","8037","4464","3573","100.11","高雄市"
"436","阿蓮區","12","276","9225","30193","15223","14970","100.11","高雄市"
"437","路竹區","20","395","16175","53496","27299","26197","100.11","高雄市"
"438","湖內區","14","260","9768","28817","14826","13991","100.11","高雄市"
"439","茄萣區","15","339","10184","31011","16136","14875","100.11","高雄市"
"440","永安區","6","81","5812","14119","7183","6936","100.11","高雄市"
"441","彌陀區","12","227","6672","20227","10502","9725","100.11","高雄市"
"442","梓官區","15","286","12143","36602","19003","17599","100.11","高雄市"
"443","旗山區","21","381","13862","39471","20534","18937","100.11","高雄市"
"444","美濃區","19","389","14310","42686","22307","20379","100.11","高雄市"
"445","六龜區","12","221","5753","14447","7813","6634","100.11","高雄市"
"446","甲仙區","7","103","2494","6999","3752","3247","100.11","高雄市"
"447","杉林區","7","138","4587","12120","6613","5507","100.11","高雄市"
"448","內門區","18","207","5051","15679","8554","7125","100.11","高雄市"
"449","茂林區","3","19","575","1831","919","912","100.11","高雄市"
"450","桃源區","8","39","1365","4712","2484","2228","100.11","高雄市"
"451","那瑪夏區","3","20","883","3264","1691","1573","100.11","高雄市"
"452","高雄市","893","17670","1035012","2774470","1388530","1385940","100.12","高雄市"
"453","鹽埕區","21","237","11053","26723","13377","13346","100.12","高雄市"
"454","鼓山區","38","722","53167","132868","64928","67940","100.12","高雄市"
"455","左營區","40","747","74877","193482","94930","98552","100.12","高雄市"
"456","楠梓區","37","803","62664","173969","86155","87814","100.12","高雄市"
"457","三民一","41","662","33250","85216","42456","42760","100.12","高雄市"
"458","三民二","45","1082","99435","266943","129607","137336","100.12","高雄市"
"459","新興區","32","456","22798","54345","26331","28014","100.12","高雄市"
"460","前金區","20","263","12506","28446","13841","14605","100.12","高雄市"
"461","苓雅區","69","1248","72018","181717","88271","93446","100.12","高雄市"
"462","前鎮區","59","1298","76930","197693","98066","99627","100.12","高雄市"
"463","旗津區","13","212","10993","29781","15436","14345","100.12","高雄市"
"464","小港區","38","697","64255","154772","77627","77145","100.12","高雄市"
"465","鳳山一","43","1113","66751","176676","87204","89472","100.12","高雄市"
"466","鳳山二","35","1007","62586","168670","84282","84388","100.12","高雄市"
"467","林園區","24","521","24616","70439","36072","34367","100.12","高雄市"
"468","大寮區","25","747","38965","109157","56609","52548","100.12","高雄市"
"469","大樹區","18","376","13111","43609","22522","21087","100.12","高雄市"
"470","大社區","9","175","11905","33296","17052","16244","100.12","高雄市"
"471","仁武區","16","389","27178","74867","38597","36270","100.12","高雄市"
"472","鳥松區","7","192","16901","43191","21883","21308","100.12","高雄市"
"473","岡山區","33","540","33621","97417","48796","48621","100.12","高雄市"
"474","橋頭區","17","359","12884","36809","18841","17968","100.12","高雄市"
"475","燕巢區","11","289","10147","30941","16499","14442","100.12","高雄市"
"476","田寮區","10","154","3520","8012","4450","3562","100.12","高雄市"
"477","阿蓮區","12","276","9233","30225","15240","14985","100.12","高雄市"
"478","路竹區","20","395","16175","53443","27277","26166","100.12","高雄市"
"479","湖內區","14","260","9770","28806","14818","13988","100.12","高雄市"
"480","茄萣區","15","339","10189","31008","16127","14881","100.12","高雄市"
"481","永安區","6","81","5805","14106","7168","6938","100.12","高雄市"
"482","彌陀區","12","227","6677","20217","10495","9722","100.12","高雄市"
"483","梓官區","15","286","12145","36559","18993","17566","100.12","高雄市"
"484","旗山區","21","381","13852","39423","20508","18915","100.12","高雄市"
"485","美濃區","19","389","14316","42658","22285","20373","100.12","高雄市"
"486","六龜區","12","221","5758","14421","7799","6622","100.12","高雄市"
"487","甲仙區","7","103","2493","6981","3741","3240","100.12","高雄市"
"488","杉林區","7","138","4593","12136","6621","5515","100.12","高雄市"
"489","內門區","18","207","5052","15662","8537","7125","100.12","高雄市"
"490","茂林區","3","19","574","1834","922","912","100.12","高雄市"
"491","桃源區","8","39","1367","4700","2480","2220","100.12","高雄市"
"492","那瑪夏區","3","20","882","3252","1687","1565","100.12","高雄市"
"493","高雄市","893","17670","1035310","2774925","1388542","1386383","101.1","高雄市"
"494","鹽埕區","21","237","11058","26701","13370","13331","101.1","高雄市"
"495","鼓山區","38","722","53178","132959","64962","67997","101.1","高雄市"
"496","左營區","40","747","74932","193695","94984","98711","101.1","高雄市"
"497","楠梓區","37","803","62702","174025","86199","87826","101.1","高雄市"
"498","三民一","41","662","33235","85134","42412","42722","101.1","高雄市"
"499","三民二","45","1082","99412","266857","129509","137348","101.1","高雄市"
"500","新興區","32","456","22781","54322","26303","28019","101.1","高雄市"
"501","前金區","20","263","12491","28397","13811","14586","101.1","高雄市"
"502","苓雅區","69","1248","72043","181630","88236","93394","101.1","高雄市"
"503","前鎮區","59","1298","76908","197593","98016","99577","101.1","高雄市"
"504","旗津區","13","212","10989","29752","15414","14338","101.1","高雄市"
"505","小港區","38","697","64276","154875","77674","77201","101.1","高雄市"
"506","鳳山一","43","1113","66808","176875","87279","89596","101.1","高雄市"
"507","鳳山二","35","1007","62617","168904","84391","84513","101.1","高雄市"
"508","林園區","24","521","24643","70436","36071","34365","101.1","高雄市"
"509","大寮區","25","747","38989","109173","56602","52571","101.1","高雄市"
"510","大樹區","18","376","13102","43600","22515","21085","101.1","高雄市"
"511","大社區","9","175","11915","33345","17084","16261","101.1","高雄市"
"512","仁武區","16","389","27222","74999","38659","36340","101.1","高雄市"
"513","鳥松區","7","192","16896","43203","21877","21326","101.1","高雄市"
"514","岡山區","33","540","33644","97454","48795","48659","101.1","高雄市"
"515","橋頭區","17","359","12893","36824","18849","17975","101.1","高雄市"
"516","燕巢區","11","289","10141","30902","16485","14417","101.1","高雄市"
"517","田寮區","10","154","3513","7995","4444","3551","101.1","高雄市"
"518","阿蓮區","12","276","9235","30215","15233","14982","101.1","高雄市"
"519","路竹區","20","395","16182","53439","27274","26165","101.1","高雄市"
"520","湖內區","14","260","9779","28825","14828","13997","101.1","高雄市"
"521","茄萣區","15","339","10192","30987","16117","14870","101.1","高雄市"
"522","永安區","6","81","5791","14076","7148","6928","101.1","高雄市"
"523","彌陀區","12","227","6681","20224","10489","9735","101.1","高雄市"
"524","梓官區","15","286","12159","36574","19006","17568","101.1","高雄市"
"525","旗山區","21","381","13858","39416","20503","18913","101.1","高雄市"
"526","美濃區","19","389","14324","42621","22261","20360","101.1","高雄市"
"527","六龜區","12","221","5758","14387","7785","6602","101.1","高雄市"
"528","甲仙區","7","103","2483","6931","3711","3220","101.1","高雄市"
"529","杉林區","7","138","4607","12165","6637","5528","101.1","高雄市"
"530","內門區","18","207","5048","15639","8523","7116","101.1","高雄市"
"531","茂林區","3","19","574","1833","921","912","101.1","高雄市"
"532","桃源區","8","39","1371","4700","2483","2217","101.1","高雄市"
"533","那瑪夏區","3","20","880","3243","1682","1561","101.1","高雄市"
"534","高雄市","893","17670","1036151","2774831","1388254","1386577","101.2","高雄市"
"535","鹽埕區","21","237","11079","26695","13359","13336","101.2","高雄市"
"536","鼓山區","38","722","53226","132877","64927","67950","101.2","高雄市"
"537","左營區","40","747","75000","193892","95040","98852","101.2","高雄市"
"538","楠梓區","37","803","62778","174135","86241","87894","101.2","高雄市"
"539","三民一","41","662","33238","85041","42355","42686","101.2","高雄市"
"540","三民二","45","1082","99417","266635","129388","137247","101.2","高雄市"
"541","新興區","32","456","22789","54257","26258","27999","101.2","高雄市"
"542","前金區","20","263","12485","28375","13801","14574","101.2","高雄市"
"543","苓雅區","69","1248","72016","181396","88108","93288","101.2","高雄市"
"544","前鎮區","59","1298","76932","197367","97890","99477","101.2","高雄市"
"545","旗津區","13","212","11000","29705","15395","14310","101.2","高雄市"
"546","小港區","38","697","64351","155004","77764","77240","101.2","高雄市"
"547","鳳山一","43","1113","66887","176939","87278","89661","101.2","高雄市"
"548","鳳山二","35","1007","62733","169191","84527","84664","101.2","高雄市"
"549","林園區","24","521","24655","70467","36056","34411","101.2","高雄市"
"550","大寮區","25","747","39017","109205","56588","52617","101.2","高雄市"
"551","大樹區","18","376","13109","43582","22502","21080","101.2","高雄市"
"552","大社區","9","175","11925","33384","17111","16273","101.2","高雄市"
"553","仁武區","16","389","27331","75259","38763","36496","101.2","高雄市"
"554","鳥松區","7","192","16931","43313","21950","21363","101.2","高雄市"
"555","岡山區","33","540","33694","97463","48771","48692","101.2","高雄市"
"556","橋頭區","17","359","12917","36835","18845","17990","101.2","高雄市"
"557","燕巢區","11","289","10144","30881","16470","14411","101.2","高雄市"
"558","田寮區","10","154","3511","7967","4427","3540","101.2","高雄市"
"559","阿蓮區","12","276","9234","30194","15231","14963","101.2","高雄市"
"560","路竹區","20","395","16187","53418","27270","26148","101.2","高雄市"
"561","湖內區","14","260","9809","28836","14840","13996","101.2","高雄市"
"562","茄萣區","15","339","10202","30914","16084","14830","101.2","高雄市"
"563","永安區","6","81","5794","14048","7141","6907","101.2","高雄市"
"564","彌陀區","12","227","6680","20226","10483","9743","101.2","高雄市"
"565","梓官區","15","286","12167","36527","18967","17560","101.2","高雄市"
"566","旗山區","21","381","13845","39420","20487","18933","101.2","高雄市"
"567","美濃區","19","389","14321","42568","22253","20315","101.2","高雄市"
"568","六龜區","12","221","5757","14361","7766","6595","101.2","高雄市"
"569","甲仙區","7","103","2475","6886","3687","3199","101.2","高雄市"
"570","杉林區","7","138","4638","12200","6654","5546","101.2","高雄市"
"571","內門區","18","207","5047","15594","8502","7092","101.2","高雄市"
"572","茂林區","3","19","577","1847","924","923","101.2","高雄市"
"573","桃源區","8","39","1373","4688","2473","2215","101.2","高雄市"
"574","那瑪夏區","3","20","880","3239","1678","1561","101.2","高雄市"
"575","高雄市","893","17674","1037078","2774586","1387840","1386746","101.3","高雄市"
"576","鹽埕區","21","237","11064","26651","13327","13324","101.3","高雄市"
"577","鼓山區","38","722","53250","132923","64923","68000","101.3","高雄市"
"578","左營區","40","747","75023","193773","94983","98790","101.3","高雄市"
"579","楠梓區","37","803","62872","174306","86254","88052","101.3","高雄市"
"580","三民一","41","662","33191","84890","42283","42607","101.3","高雄市"
"581","三民二","45","1082","99539","266573","129315","137258","101.3","高雄市"
"582","新興區","32","456","22802","54254","26257","27997","101.3","高雄市"
"583","前金區","20","263","12490","28370","13810","14560","101.3","高雄市"
"584","苓雅區","69","1248","72012","181191","88021","93170","101.3","高雄市"
"585","前鎮區","59","1298","76949","197171","97750","99421","101.3","高雄市"
"586","旗津區","13","212","10988","29656","15389","14267","101.3","高雄市"
"587","小港區","38","697","64384","154933","77678","77255","101.3","高雄市"
"588","鳳山一","43","1113","67102","177171","87344","89827","101.3","高雄市"
"589","鳳山二","35","1007","62828","169475","84645","84830","101.3","高雄市"
"590","林園區","24","525","24685","70480","36063","34417","101.3","高雄市"
"591","大寮區","25","747","39062","109119","56543","52576","101.3","高雄市"
"592","大樹區","18","376","13119","43572","22497","21075","101.3","高雄市"
"593","大社區","9","175","11934","33416","17133","16283","101.3","高雄市"
"594","仁武區","16","389","27450","75457","38872","36585","101.3","高雄市"
"595","鳥松區","7","192","16933","43330","21967","21363","101.3","高雄市"
"596","岡山區","33","540","33733","97434","48742","48692","101.3","高雄市"
"597","橋頭區","17","359","12918","36821","18829","17992","101.3","高雄市"
"598","燕巢區","11","289","10155","30881","16453","14428","101.3","高雄市"
"599","田寮區","10","154","3508","7956","4424","3532","101.3","高雄市"
"600","阿蓮區","12","276","9236","30170","15223","14947","101.3","高雄市"
"601","路竹區","20","395","16200","53418","27277","26141","101.3","高雄市"
"602","湖內區","14","260","9843","28866","14847","14019","101.3","高雄市"
"603","茄萣區","15","339","10199","30851","16053","14798","101.3","高雄市"
"604","永安區","6","81","5793","14061","7146","6915","101.3","高雄市"
"605","彌陀區","12","227","6679","20235","10488","9747","101.3","高雄市"
"606","梓官區","15","286","12188","36541","18982","17559","101.3","高雄市"
"607","旗山區","21","381","13859","39376","20460","18916","101.3","高雄市"
"608","美濃區","19","389","14322","42508","22214","20294","101.3","高雄市"
"609","六龜區","12","221","5751","14315","7743","6572","101.3","高雄市"
"610","甲仙區","7","103","2466","6839","3656","3183","101.3","高雄市"
"611","杉林區","7","138","4669","12255","6685","5570","101.3","高雄市"
"612","內門區","18","207","5052","15592","8503","7089","101.3","高雄市"
"613","茂林區","3","19","578","1840","921","919","101.3","高雄市"
"614","桃源區","8","39","1370","4677","2465","2212","101.3","高雄市"
"615","那瑪夏區","3","20","882","3239","1675","1564","101.3","高雄市"
"616","高雄市","893","17675","1038014","2774649","1387633","1387016","101.4","高雄市"
"617","鹽埕區","21","237","11061","26606","13289","13317","101.4","高雄市"
"618","鼓山區","38","722","53317","133038","64956","68082","101.4","高雄市"
"619","左營區","40","747","75139","193941","95045","98896","101.4","高雄市"
"620","楠梓區","37","803","62935","174380","86295","88085","101.4","高雄市"
"621","三民一","41","662","33159","84779","42202","42577","101.4","高雄市"
"622","三民二","45","1082","99594","266435","129257","137178","101.4","高雄市"
"623","新興區","32","456","22813","54264","26263","28001","101.4","高雄市"
"624","前金區","20","263","12485","28339","13800","14539","101.4","高雄市"
"625","苓雅區","69","1248","72007","180979","87925","93054","101.4","高雄市"
"626","前鎮區","59","1298","76986","197001","97697","99304","101.4","高雄市"
"627","旗津區","13","212","10979","29599","15362","14237","101.4","高雄市"
"628","小港區","38","697","64428","154923","77646","77277","101.4","高雄市"
"629","鳳山一","43","1114","67256","177277","87357","89920","101.4","高雄市"
"630","鳳山二","35","1007","62903","169639","84688","84951","101.4","高雄市"
"631","林園區","24","525","24706","70469","36060","34409","101.4","高雄市"
"632","大寮區","25","747","39127","109176","56559","52617","101.4","高雄市"
"633","大樹區","18","376","13121","43542","22466","21076","101.4","高雄市"
"634","大社區","9","175","11955","33472","17157","16315","101.4","高雄市"
"635","仁武區","16","389","27537","75727","38973","36754","101.4","高雄市"
"636","鳥松區","7","192","16968","43339","21965","21374","101.4","高雄市"
"637","岡山區","33","540","33761","97460","48752","48708","101.4","高雄市"
"638","橋頭區","17","359","12930","36786","18809","17977","101.4","高雄市"
"639","燕巢區","11","289","10147","30884","16440","14444","101.4","高雄市"
"640","田寮區","10","154","3505","7951","4421","3530","101.4","高雄市"
"641","阿蓮區","12","276","9244","30146","15214","14932","101.4","高雄市"
"642","路竹區","20","395","16214","53359","27248","26111","101.4","高雄市"
"643","湖內區","14","260","9868","28876","14846","14030","101.4","高雄市"
"644","茄萣區","15","339","10218","30880","16058","14822","101.4","高雄市"
"645","永安區","6","81","5797","14074","7148","6926","101.4","高雄市"
"646","彌陀區","12","227","6677","20221","10477","9744","101.4","高雄市"
"647","梓官區","15","286","12203","36536","18984","17552","101.4","高雄市"
"648","旗山區","21","381","13866","39368","20455","18913","101.4","高雄市"
"649","美濃區","19","389","14326","42467","22185","20282","101.4","高雄市"
"650","六龜區","12","221","5746","14297","7740","6557","101.4","高雄市"
"651","甲仙區","7","103","2454","6791","3624","3167","101.4","高雄市"
"652","杉林區","7","138","4697","12305","6716","5589","101.4","高雄市"
"653","內門區","18","207","5052","15584","8500","7084","101.4","高雄市"
"654","茂林區","3","19","580","1843","923","920","101.4","高雄市"
"655","桃源區","8","39","1371","4664","2461","2203","101.4","高雄市"
"656","那瑪夏區","3","20","882","3232","1670","1562","101.4","高雄市"
"657","高雄市","893","17674","1039050","2774730","1387515","1387215","101.5","高雄市"
"658","鹽埕區","21","237","11036","26558","13256","13302","101.5","高雄市"
"659","鼓山區","38","722","53384","133171","65034","68137","101.5","高雄市"
"660","左營區","40","747","75212","194054","95082","98972","101.5","高雄市"
"661","楠梓區","37","803","62993","174447","86351","88096","101.5","高雄市"
"662","三民一","41","662","33147","84649","42103","42546","101.5","高雄市"
"663","三民二","45","1082","99633","266347","129166","137181","101.5","高雄市"
"664","新興區","32","456","22805","54188","26230","27958","101.5","高雄市"
"665","前金區","20","263","12487","28323","13788","14535","101.5","高雄市"
"666","苓雅區","69","1248","72021","180723","87822","92901","101.5","高雄市"
"667","前鎮區","59","1298","77087","196969","97680","99289","101.5","高雄市"
"668","旗津區","13","212","10978","29565","15336","14229","101.5","高雄市"
"669","小港區","38","697","64492","154971","77653","77318","101.5","高雄市"
"670","鳳山一","43","1113","67407","177484","87466","90018","101.5","高雄市"
"671","鳳山二","35","1007","62977","169812","84743","85069","101.5","高雄市"
"672","林園區","24","525","24767","70483","36040","34443","101.5","高雄市"
"673","大寮區","25","747","39167","109111","56513","52598","101.5","高雄市"
"674","大樹區","18","376","13139","43515","22450","21065","101.5","高雄市"
"675","大社區","9","175","11971","33503","17174","16329","101.5","高雄市"
"676","仁武區","16","389","27671","76022","39137","36885","101.5","高雄市"
"677","鳥松區","7","192","16999","43376","22002","21374","101.5","高雄市"
"678","岡山區","33","540","33789","97461","48735","48726","101.5","高雄市"
"679","橋頭區","17","359","12940","36815","18827","17988","101.5","高雄市"
"680","燕巢區","11","289","10166","30848","16429","14419","101.5","高雄市"
"681","田寮區","10","154","3506","7926","4410","3516","101.5","高雄市"
"682","阿蓮區","12","276","9259","30116","15197","14919","101.5","高雄市"
"683","路竹區","20","395","16220","53344","27225","26119","101.5","高雄市"
"684","湖內區","14","260","9876","28886","14859","14027","101.5","高雄市"
"685","茄萣區","15","339","10229","30895","16065","14830","101.5","高雄市"
"686","永安區","6","81","5806","14077","7150","6927","101.5","高雄市"
"687","彌陀區","12","227","6675","20211","10463","9748","101.5","高雄市"
"688","梓官區","15","286","12215","36511","18967","17544","101.5","高雄市"
"689","旗山區","21","381","13859","39299","20410","18889","101.5","高雄市"
"690","美濃區","19","389","14343","42402","22159","20243","101.5","高雄市"
"691","六龜區","12","221","5748","14293","7737","6556","101.5","高雄市"
"692","甲仙區","7","103","2434","6743","3593","3150","101.5","高雄市"
"693","杉林區","7","138","4725","12337","6732","5605","101.5","高雄市"
"694","內門區","18","207","5057","15585","8498","7087","101.5","高雄市"
"695","茂林區","3","19","579","1843","922","921","101.5","高雄市"
"696","桃源區","8","39","1369","4650","2451","2199","101.5","高雄市"
"697","那瑪夏區","3","20","882","3217","1660","1557","101.5","高雄市"
"698","高雄市","893","17674","1039797","2775482","1387701","1387781","101.6","高雄市"
"699","鹽埕區","21","237","11027","26546","13247","13299","101.6","高雄市"
"700","鼓山區","38","722","53456","133297","65078","68219","101.6","高雄市"
"701","左營區","40","747","75196","194117","95081","99036","101.6","高雄市"
"702","楠梓區","37","803","63095","174615","86465","88150","101.6","高雄市"
"703","三民一","41","662","33141","84531","42054","42477","101.6","高雄市"
"704","三民二","45","1082","99671","266299","129136","137163","101.6","高雄市"
"705","新興區","32","456","22804","54149","26201","27948","101.6","高雄市"
"706","前金區","20","263","12507","28337","13783","14554","101.6","高雄市"
"707","苓雅區","69","1248","72071","180600","87729","92871","101.6","高雄市"
"708","前鎮區","59","1298","77148","196949","97633","99316","101.6","高雄市"
"709","旗津區","13","212","10967","29539","15329","14210","101.6","高雄市"
"710","小港區","38","697","64599","155139","77733","77406","101.6","高雄市"
"711","鳳山一","43","1113","67465","177582","87452","90130","101.6","高雄市"
"712","鳳山二","35","1007","63028","169978","84814","85164","101.6","高雄市"
"713","林園區","24","525","24777","70421","36028","34393","101.6","高雄市"
"714","大寮區","25","747","39205","109171","56561","52610","101.6","高雄市"
"715","大樹區","18","376","13128","43512","22444","21068","101.6","高雄市"
"716","大社區","9","175","11989","33542","17189","16353","101.6","高雄市"
"717","仁武區","16","389","27752","76239","39264","36975","101.6","高雄市"
"718","鳥松區","7","192","17013","43417","22018","21399","101.6","高雄市"
"719","岡山區","33","540","33803","97469","48739","48730","101.6","高雄市"
"720","橋頭區","17","359","12939","36840","18842","17998","101.6","高雄市"
"721","燕巢區","11","289","10184","30868","16433","14435","101.6","高雄市"
"722","田寮區","10","154","3502","7925","4411","3514","101.6","高雄市"
"723","阿蓮區","12","276","9270","30121","15207","14914","101.6","高雄市"
"724","路竹區","20","395","16230","53334","27220","26114","101.6","高雄市"
"725","湖內區","14","260","9900","28918","14875","14043","101.6","高雄市"
"726","茄萣區","15","339","10240","30916","16070","14846","101.6","高雄市"
"727","永安區","6","81","5810","14090","7150","6940","101.6","高雄市"
"728","彌陀區","12","227","6678","20226","10469","9757","101.6","高雄市"
"729","梓官區","15","286","12227","36508","18954","17554","101.6","高雄市"
"730","旗山區","21","381","13856","39271","20386","18885","101.6","高雄市"
"731","美濃區","19","389","14331","42374","22135","20239","101.6","高雄市"
"732","六龜區","12","221","5747","14278","7722","6556","101.6","高雄市"
"733","甲仙區","7","103","2435","6736","3589","3147","101.6","高雄市"
"734","杉林區","7","138","4727","12359","6741","5618","101.6","高雄市"
"735","內門區","18","207","5058","15592","8503","7089","101.6","高雄市"
"736","茂林區","3","19","578","1840","920","920","101.6","高雄市"
"737","桃源區","8","39","1364","4629","2440","2189","101.6","高雄市"
"738","那瑪夏區","3","20","879","3208","1656","1552","101.6","高雄市"
"739","高雄市","893","17687","1041365","2775734","1387586","1388148","101.7","高雄市"
"740","鹽埕區","21","237","11031","26509","13227","13282","101.7","高雄市"
"741","鼓山區","38","722","53620","133491","65133","68358","101.7","高雄市"
"742","左營區","40","760","75330","194182","95071","99111","101.7","高雄市"
"743","楠梓區","37","803","63273","174870","86605","88265","101.7","高雄市"
"744","三民一","41","662","33131","84348","41964","42384","101.7","高雄市"
"745","三民二","45","1082","99792","266182","129083","137099","101.7","高雄市"
"746","新興區","32","456","22813","54062","26162","27900","101.7","高雄市"
"747","前金區","20","263","12535","28323","13768","14555","101.7","高雄市"
"748","苓雅區","69","1248","72116","180429","87632","92797","101.7","高雄市"
"749","前鎮區","59","1298","77218","196811","97532","99279","101.7","高雄市"
"750","旗津區","13","212","10969","29527","15312","14215","101.7","高雄市"
"751","小港區","38","697","64656","155156","77730","77426","101.7","高雄市"
"752","鳳山一","43","1113","67616","177724","87521","90203","101.7","高雄市"
"753","鳳山二","35","1007","63170","170226","84937","85289","101.7","高雄市"
"754","林園區","24","525","24812","70362","35982","34380","101.7","高雄市"
"755","大寮區","25","747","39285","109310","56602","52708","101.7","高雄市"
"756","大樹區","18","376","13117","43430","22410","21020","101.7","高雄市"
"757","大社區","9","175","12014","33577","17208","16369","101.7","高雄市"
"758","仁武區","16","389","27877","76445","39343","37102","101.7","高雄市"
"759","鳥松區","7","192","17080","43477","22054","21423","101.7","高雄市"
"760","岡山區","33","540","33853","97488","48743","48745","101.7","高雄市"
"761","橋頭區","17","359","12959","36881","18854","18027","101.7","高雄市"
"762","燕巢區","11","289","10165","30834","16391","14443","101.7","高雄市"
"763","田寮區","10","154","3498","7897","4397","3500","101.7","高雄市"
"764","阿蓮區","12","276","9279","30095","15196","14899","101.7","高雄市"
"765","路竹區","20","395","16252","53324","27229","26095","101.7","高雄市"
"766","湖內區","14","260","9927","28932","14883","14049","101.7","高雄市"
"767","茄萣區","15","339","10252","30941","16082","14859","101.7","高雄市"
"768","永安區","6","81","5836","14105","7146","6959","101.7","高雄市"
"769","彌陀區","12","227","6686","20199","10460","9739","101.7","高雄市"
"770","梓官區","15","286","12228","36481","18941","17540","101.7","高雄市"
"771","旗山區","21","381","13854","39202","20338","18864","101.7","高雄市"
"772","美濃區","19","389","14331","42308","22106","20202","101.7","高雄市"
"773","六龜區","12","221","5745","14271","7713","6558","101.7","高雄市"
"774","甲仙區","7","103","2428","6706","3574","3132","101.7","高雄市"
"775","杉林區","7","138","4743","12415","6763","5652","101.7","高雄市"
"776","內門區","18","207","5049","15546","8481","7065","101.7","高雄市"
"777","茂林區","3","19","580","1837","919","918","101.7","高雄市"
"778","桃源區","8","39","1367","4624","2438","2186","101.7","高雄市"
"779","那瑪夏區","3","20","878","3207","1656","1551","101.7","高雄市"
"780","高雄市","893","17687","1043274","2776204","1387643","1388561","101.8","高雄市"
"781","鹽埕區","21","237","11037","26449","13198","13251","101.8","高雄市"
"782","鼓山區","38","722","53742","133560","65150","68410","101.8","高雄市"
"783","左營區","40","760","75510","194259","95084","99175","101.8","高雄市"
"784","楠梓區","37","803","63476","175056","86694","88362","101.8","高雄市"
"785","三民一","41","662","33139","84239","41908","42331","101.8","高雄市"
"786","三民二","45","1082","99922","266119","129027","137092","101.8","高雄市"
"787","新興區","32","456","22837","53995","26146","27849","101.8","高雄市"
"788","前金區","20","263","12563","28290","13750","14540","101.8","高雄市"
"789","苓雅區","69","1248","72177","180153","87514","92639","101.8","高雄市"
"790","前鎮區","59","1298","77285","196753","97516","99237","101.8","高雄市"
"791","旗津區","13","212","10968","29506","15312","14194","101.8","高雄市"
"792","小港區","38","697","64738","155226","77751","77475","101.8","高雄市"
"793","鳳山一","43","1113","67800","177850","87548","90302","101.8","高雄市"
"794","鳳山二","35","1007","63339","170467","85028","85439","101.8","高雄市"
"795","林園區","24","525","24850","70344","35960","34384","101.8","高雄市"
"796","大寮區","25","747","39401","109457","56657","52800","101.8","高雄市"
"797","大樹區","18","376","13132","43412","22410","21002","101.8","高雄市"
"798","大社區","9","175","12049","33650","17242","16408","101.8","高雄市"
"799","仁武區","16","389","28038","76719","39459","37260","101.8","高雄市"
"800","鳥松區","7","192","17135","43532","22088","21444","101.8","高雄市"
"801","岡山區","33","540","33898","97500","48703","48797","101.8","高雄市"
"802","橋頭區","17","359","12958","36928","18863","18065","101.8","高雄市"
"803","燕巢區","11","289","10180","30832","16380","14452","101.8","高雄市"
"804","田寮區","10","154","3497","7902","4404","3498","101.8","高雄市"
"805","阿蓮區","12","276","9283","30060","15183","14877","101.8","高雄市"
"806","路竹區","20","395","16285","53262","27209","26053","101.8","高雄市"
"807","湖內區","14","260","9969","28983","14905","14078","101.8","高雄市"
"808","茄萣區","15","339","10263","30953","16088","14865","101.8","高雄市"
"809","永安區","6","81","5842","14126","7162","6964","101.8","高雄市"
"810","彌陀區","12","227","6690","20176","10461","9715","101.8","高雄市"
"811","梓官區","15","286","12252","36508","18952","17556","101.8","高雄市"
"812","旗山區","21","381","13859","39144","20312","18832","101.8","高雄市"
"813","美濃區","19","389","14347","42247","22071","20176","101.8","高雄市"
"814","六龜區","12","221","5744","14246","7695","6551","101.8","高雄市"
"815","甲仙區","7","103","2428","6689","3563","3126","101.8","高雄市"
"816","杉林區","7","138","4770","12448","6777","5671","101.8","高雄市"
"817","內門區","18","207","5048","15552","8487","7065","101.8","高雄市"
"818","茂林區","3","19","581","1836","915","921","101.8","高雄市"
"819","桃源區","8","39","1365","4591","2423","2168","101.8","高雄市"
"820","那瑪夏區","3","20","877","3185","1648","1537","101.8","高雄市"
"821","高雄市","893","17687","1045314","2776550","1387596","1388954","101.9","高雄市"
"822","鹽埕區","21","237","11053","26375","13164","13211","101.9","高雄市"
"823","鼓山區","38","722","53880","133740","65214","68526","101.9","高雄市"
"824","左營區","40","760","75645","194307","95050","99257","101.9","高雄市"
"825","楠梓區","37","803","63738","175254","86817","88437","101.9","高雄市"
"826","三民一","41","662","33157","84107","41830","42277","101.9","高雄市"
"827","三民二","45","1082","100098","265974","128929","137045","101.9","高雄市"
"828","新興區","32","456","22844","53871","26078","27793","101.9","高雄市"
"829","前金區","20","263","12594","28270","13743","14527","101.9","高雄市"
"830","苓雅區","69","1248","72250","179913","87365","92548","101.9","高雄市"
"831","前鎮區","59","1298","77360","196648","97443","99205","101.9","高雄市"
"832","旗津區","13","212","10991","29529","15319","14210","101.9","高雄市"
"833","小港區","38","697","64842","155267","77760","77507","101.9","高雄市"
"834","鳳山一","43","1113","67997","177930","87592","90338","101.9","高雄市"
"835","鳳山二","35","1007","63502","170765","85160","85605","101.9","高雄市"
"836","林園區","24","525","24878","70319","35956","34363","101.9","高雄市"
"837","大寮區","25","747","39543","109562","56681","52881","101.9","高雄市"
"838","大樹區","18","376","13150","43444","22433","21011","101.9","高雄市"
"839","大社區","9","175","12086","33699","17255","16444","101.9","高雄市"
"840","仁武區","16","389","28189","77003","39593","37410","101.9","高雄市"
"841","鳥松區","7","192","17168","43572","22112","21460","101.9","高雄市"
"842","岡山區","33","540","33956","97511","48711","48800","101.9","高雄市"
"843","橋頭區","17","359","12980","36923","18852","18071","101.9","高雄市"
"844","燕巢區","11","289","10168","30810","16368","14442","101.9","高雄市"
"845","田寮區","10","154","3491","7878","4399","3479","101.9","高雄市"
"846","阿蓮區","12","276","9303","30045","15177","14868","101.9","高雄市"
"847","路竹區","20","395","16324","53241","27198","26043","101.9","高雄市"
"848","湖內區","14","260","10005","29055","14947","14108","101.9","高雄市"
"849","茄萣區","15","339","10267","30966","16084","14882","101.9","高雄市"
"850","永安區","6","81","5833","14118","7154","6964","101.9","高雄市"
"851","彌陀區","12","227","6690","20157","10465","9692","101.9","高雄市"
"852","梓官區","15","286","12263","36473","18921","17552","101.9","高雄市"
"853","旗山區","21","381","13867","39101","20288","18813","101.9","高雄市"
"854","美濃區","19","389","14370","42214","22047","20167","101.9","高雄市"
"855","六龜區","12","221","5747","14241","7695","6546","101.9","高雄市"
"856","甲仙區","7","103","2428","6674","3559","3115","101.9","高雄市"
"857","杉林區","7","138","4778","12461","6781","5680","101.9","高雄市"
"858","內門區","18","207","5055","15533","8479","7054","101.9","高雄市"
"859","茂林區","3","19","580","1831","915","916","101.9","高雄市"
"860","桃源區","8","39","1364","4586","2420","2166","101.9","高雄市"
"861","那瑪夏區","3","20","880","3183","1642","1541","101.9","高雄市"
"862","高雄市","893","17687","1045437","2777128","1387672","1389456","101.10","高雄市"
"863","鹽埕區","21","237","11034","26300","13144","13156","101.10","高雄市"
"864","鼓山區","38","722","53884","133781","65208","68573","101.10","高雄市"
"865","左營區","40","760","75625","194520","95121","99399","101.10","高雄市"
"866","楠梓區","37","803","63767","175413","86888","88525","101.10","高雄市"
"867","三民一","41","662","33132","84047","41771","42276","101.10","高雄市"
"868","三民二","45","1082","100100","265972","128873","137099","101.10","高雄市"
"869","新興區","32","456","22837","53801","26041","27760","101.10","高雄市"
"870","前金區","20","263","12571","28223","13713","14510","101.10","高雄市"
"871","苓雅區","69","1248","72182","179727","87246","92481","101.10","高雄市"
"872","前鎮區","59","1298","77331","196528","97388","99140","101.10","高雄市"
"873","旗津區","13","212","10989","29537","15335","14202","101.10","高雄市"
"874","小港區","38","697","64857","155331","77754","77577","101.10","高雄市"
"875","鳳山一","43","1113","68053","178060","87628","90432","101.10","高雄市"
"876","鳳山二","35","1007","63560","171029","85280","85749","101.10","高雄市"
"877","林園區","24","525","24925","70365","35985","34380","101.10","高雄市"
"878","大寮區","25","747","39564","109606","56709","52897","101.10","高雄市"
"879","大樹區","18","376","13138","43400","22418","20982","101.10","高雄市"
"880","大社區","9","175","12084","33694","17259","16435","101.10","高雄市"
"881","仁武區","16","389","28227","77142","39640","37502","101.10","高雄市"
"882","鳥松區","7","192","17179","43590","22137","21453","101.10","高雄市"
"883","岡山區","33","540","33970","97536","48719","48817","101.10","高雄市"
"884","橋頭區","17","359","12991","36960","18877","18083","101.10","高雄市"
"885","燕巢區","11","289","10185","30828","16380","14448","101.10","高雄市"
"886","田寮區","10","154","3489","7876","4396","3480","101.10","高雄市"
"887","阿蓮區","12","276","9294","30026","15164","14862","101.10","高雄市"
"888","路竹區","20","395","16306","53204","27189","26015","101.10","高雄市"
"889","湖內區","14","260","10001","29081","14958","14123","101.10","高雄市"
"890","茄萣區","15","339","10277","30977","16094","14883","101.10","高雄市"
"891","永安區","6","81","5829","14119","7152","6967","101.10","高雄市"
"892","彌陀區","12","227","6687","20138","10464","9674","101.10","高雄市"
"893","梓官區","15","286","12283","36518","18941","17577","101.10","高雄市"
"894","旗山區","21","381","13870","39089","20271","18818","101.10","高雄市"
"895","美濃區","19","389","14376","42197","22033","20164","101.10","高雄市"
"896","六龜區","12","221","5750","14233","7687","6546","101.10","高雄市"
"897","甲仙區","7","103","2426","6660","3553","3107","101.10","高雄市"
"898","杉林區","7","138","4784","12466","6781","5685","101.10","高雄市"
"899","內門區","18","207","5052","15537","8488","7049","101.10","高雄市"
"900","茂林區","3","19","581","1839","921","918","101.10","高雄市"
"901","桃源區","8","39","1362","4584","2419","2165","101.10","高雄市"
"902","那瑪夏區","3","20","885","3194","1647","1547","101.10","高雄市"
"903","高雄市","893","17687","1046080","2777897","1387842","1390055","101.11","高雄市"
"904","鹽埕區","21","237","11029","26277","13114","13163","101.11","高雄市"
"905","鼓山區","38","722","53933","133851","65203","68648","101.11","高雄市"
"906","左營區","40","760","75649","194669","95125","99544","101.11","高雄市"
"907","楠梓區","37","803","63832","175636","87007","88629","101.11","高雄市"
"908","三民一","41","662","33107","83970","41703","42267","101.11","高雄市"
"909","三民二","45","1082","100084","265878","128818","137060","101.11","高雄市"
"910","新興區","32","456","22839","53809","26031","27778","101.11","高雄市"
"911","前金區","20","263","12552","28202","13701","14501","101.11","高雄市"
"912","苓雅區","69","1248","72173","179615","87179","92436","101.11","高雄市"
"913","前鎮區","59","1298","77317","196383","97306","99077","101.11","高雄市"
"914","旗津區","13","212","10985","29489","15312","14177","101.11","高雄市"
"915","小港區","38","697","64990","155595","77881","77714","101.11","高雄市"
"916","鳳山一","43","1113","68148","178257","87718","90539","101.11","高雄市"
"917","鳳山二","35","1007","63643","171246","85371","85875","101.11","高雄市"
"918","林園區","24","525","24940","70393","35993","34400","101.11","高雄市"
"919","大寮區","25","747","39618","109622","56741","52881","101.11","高雄市"
"920","大樹區","18","376","13148","43436","22453","20983","101.11","高雄市"
"921","大社區","9","175","12088","33714","17269","16445","101.11","高雄市"
"922","仁武區","16","389","28324","77237","39668","37569","101.11","高雄市"
"923","鳥松區","7","192","17206","43678","22179","21499","101.11","高雄市"
"924","岡山區","33","540","33988","97564","48723","48841","101.11","高雄市"
"925","橋頭區","17","359","12991","36947","18874","18073","101.11","高雄市"
"926","燕巢區","11","289","10181","30774","16337","14437","101.11","高雄市"
"927","田寮區","10","154","3488","7866","4391","3475","101.11","高雄市"
"928","阿蓮區","12","276","9300","30040","15168","14872","101.11","高雄市"
"929","路竹區","20","395","16313","53157","27178","25979","101.11","高雄市"
"930","湖內區","14","260","10002","29072","14950","14122","101.11","高雄市"
"931","茄萣區","15","339","10283","30989","16095","14894","101.11","高雄市"
"932","永安區","6","81","5832","14108","7151","6957","101.11","高雄市"
"933","彌陀區","12","227","6700","20130","10454","9676","101.11","高雄市"
"934","梓官區","15","286","12285","36529","18952","17577","101.11","高雄市"
"935","旗山區","21","381","13875","39083","20265","18818","101.11","高雄市"
"936","美濃區","19","389","14382","42180","22029","20151","101.11","高雄市"
"937","六龜區","12","221","5754","14234","7691","6543","101.11","高雄市"
"938","甲仙區","7","103","2428","6652","3544","3108","101.11","高雄市"
"939","杉林區","7","138","4790","12472","6785","5687","101.11","高雄市"
"940","內門區","18","207","5058","15522","8486","7036","101.11","高雄市"
"941","茂林區","3","19","581","1846","926","920","101.11","高雄市"
"942","桃源區","8","39","1357","4578","2420","2158","101.11","高雄市"
"943","那瑪夏區","3","20","887","3197","1651","1546","101.11","高雄市"
"944","高雄市","893","17687","1046588","2778659","1387931","1390728","101.12","高雄市"
"945","鹽埕區","21","237","11022","26222","13082","13140","101.12","高雄市"
"946","鼓山區","38","722","53984","133964","65230","68734","101.12","高雄市"
"947","左營區","40","760","75669","194815","95194","99621","101.12","高雄市"
"948","楠梓區","37","803","63870","175798","87060","88738","101.12","高雄市"
"949","三民一","41","662","33096","83899","41683","42216","101.12","高雄市"
"950","三民二","45","1082","100098","265811","128793","137018","101.12","高雄市"
"951","新興區","32","456","22808","53749","25990","27759","101.12","高雄市"
"952","前金區","20","263","12567","28250","13716","14534","101.12","高雄市"
"953","苓雅區","69","1248","72166","179512","87073","92439","101.12","高雄市"
"954","前鎮區","59","1298","77282","196246","97221","99025","101.12","高雄市"
"955","旗津區","13","212","10988","29468","15286","14182","101.12","高雄市"
"956","小港區","38","697","65076","155779","77934","77845","101.12","高雄市"
"957","鳳山一","43","1113","68234","178432","87769","90663","101.12","高雄市"
"958","鳳山二","35","1007","63679","171384","85438","85946","101.12","高雄市"
"959","林園區","24","525","24965","70383","35981","34402","101.12","高雄市"
"960","大寮區","25","747","39667","109780","56812","52968","101.12","高雄市"
"961","大樹區","18","376","13148","43429","22440","20989","101.12","高雄市"
"962","大社區","9","175","12114","33766","17289","16477","101.12","高雄市"
"963","仁武區","16","389","28374","77371","39735","37636","101.12","高雄市"
"964","鳥松區","7","192","17211","43696","22191","21505","101.12","高雄市"
"965","岡山區","33","540","33994","97587","48723","48864","101.12","高雄市"
"966","橋頭區","17","359","13016","36962","18870","18092","101.12","高雄市"
"967","燕巢區","11","289","10176","30758","16336","14422","101.12","高雄市"
"968","田寮區","10","154","3487","7852","4386","3466","101.12","高雄市"
"969","阿蓮區","12","276","9318","30033","15151","14882","101.12","高雄市"
"970","路竹區","20","395","16324","53145","27168","25977","101.12","高雄市"
"971","湖內區","14","260","10027","29120","14973","14147","101.12","高雄市"
"972","茄萣區","15","339","10291","30999","16097","14902","101.12","高雄市"
"973","永安區","6","81","5829","14129","7154","6975","101.12","高雄市"
"974","彌陀區","12","227","6708","20123","10454","9669","101.12","高雄市"
"975","梓官區","15","286","12290","36519","18930","17589","101.12","高雄市"
"976","旗山區","21","381","13882","39038","20247","18791","101.12","高雄市"
"977","美濃區","19","389","14392","42157","22018","20139","101.12","高雄市"
"978","六龜區","12","221","5735","14203","7675","6528","101.12","高雄市"
"979","甲仙區","7","103","2412","6625","3530","3095","101.12","高雄市"
"980","杉林區","7","138","4827","12577","6858","5719","101.12","高雄市"
"981","內門區","18","207","5054","15510","8474","7036","101.12","高雄市"
"982","茂林區","3","19","578","1839","925","914","101.12","高雄市"
"983","桃源區","8","39","1349","4559","2408","2151","101.12","高雄市"
"984","那瑪夏區","3","20","881","3170","1637","1533","101.12","高雄市"
"985","高雄市","893","17687","1047093","2778798","1387738","1391060","102.1","高雄市"
"986","鹽埕區","21","237","11017","26238","13092","13146","102.1","高雄市"
"987","鼓山區","38","722","54044","133977","65212","68765","102.1","高雄市"
"988","左營區","40","760","75689","194878","95190","99688","102.1","高雄市"
"989","楠梓區","37","803","63970","175973","87120","88853","102.1","高雄市"
"990","三民一","41","662","33053","83773","41632","42141","102.1","高雄市"
"991","三民二","45","1082","100155","265898","128831","137067","102.1","高雄市"
"992","新興區","32","456","22801","53717","25983","27734","102.1","高雄市"
"993","前金區","20","263","12557","28201","13687","14514","102.1","高雄市"
"994","苓雅區","69","1248","72107","179328","87010","92318","102.1","高雄市"
"995","前鎮區","59","1298","77274","195988","97061","98927","102.1","高雄市"
"996","旗津區","13","212","10979","29371","15232","14139","102.1","高雄市"
"997","小港區","38","697","65091","155874","77916","77958","102.1","高雄市"
"998","鳳山一","43","1113","68304","178610","87836","90774","102.1","高雄市"
"999","鳳山二","35","1007","63797","171672","85539","86133","102.1","高雄市"
"1000","林園區","24","525","24995","70407","35982","34425","102.1","高雄市"
"1001","大寮區","25","747","39720","109827","56830","52997","102.1","高雄市"
"1002","大樹區","18","376","13147","43369","22420","20949","102.1","高雄市"
"1003","大社區","9","175","12118","33827","17321","16506","102.1","高雄市"
"1004","仁武區","16","389","28413","77468","39766","37702","102.1","高雄市"
"1005","鳥松區","7","192","17224","43663","22153","21510","102.1","高雄市"
"1006","岡山區","33","540","34011","97644","48783","48861","102.1","高雄市"
"1007","橋頭區","17","359","13019","36988","18873","18115","102.1","高雄市"
"1008","燕巢區","11","289","10197","30736","16326","14410","102.1","高雄市"
"1009","田寮區","10","154","3480","7812","4366","3446","102.1","高雄市"
"1010","阿蓮區","12","276","9322","30023","15147","14876","102.1","高雄市"
"1011","路竹區","20","395","16335","53147","27167","25980","102.1","高雄市"
"1012","湖內區","14","260","10036","29142","14985","14157","102.1","高雄市"
"1013","茄萣區","15","339","10295","30974","16075","14899","102.1","高雄市"
"1014","永安區","6","81","5828","14122","7146","6976","102.1","高雄市"
"1015","彌陀區","12","227","6698","20079","10429","9650","102.1","高雄市"
"1016","梓官區","15","286","12289","36507","18938","17569","102.1","高雄市"
"1017","旗山區","21","381","13901","39036","20244","18792","102.1","高雄市"
"1018","美濃區","19","389","14400","42107","21983","20124","102.1","高雄市"
"1019","六龜區","12","221","5731","14185","7658","6527","102.1","高雄市"
"1020","甲仙區","7","103","2405","6614","3516","3098","102.1","高雄市"
"1021","杉林區","7","138","4830","12589","6867","5722","102.1","高雄市"
"1022","內門區","18","207","5056","15484","8456","7028","102.1","高雄市"
"1023","茂林區","3","19","577","1832","922","910","102.1","高雄市"
"1024","桃源區","8","39","1349","4547","2404","2143","102.1","高雄市"
"1025","那瑪夏區","3","20","879","3171","1640","1531","102.1","高雄市"
"1026","高雄市","893","17682","1047496","2779096","1387643","1391453","102.2","高雄市"
"1027","鹽埕區","21","232","11013","26221","13086","13135","102.2","高雄市"
"1028","鼓山區","38","722","54036","134011","65214","68797","102.2","高雄市"
"1029","左營區","40","760","75752","194997","95225","99772","102.2","高雄市"
"1030","楠梓區","37","803","64030","176091","87162","88929","102.2","高雄市"
"1031","三民一","41","662","33044","83700","41599","42101","102.2","高雄市"
"1032","三民二","45","1082","100221","265985","128849","137136","102.2","高雄市"
"1033","新興區","32","456","22792","53699","25977","27722","102.2","高雄市"
"1034","前金區","20","263","12559","28224","13708","14516","102.2","高雄市"
"1035","苓雅區","69","1248","72112","179310","86993","92317","102.2","高雄市"
"1036","前鎮區","59","1298","77259","195806","96946","98860","102.2","高雄市"
"1037","旗津區","13","212","10972","29337","15207","14130","102.2","高雄市"
"1038","小港區","38","697","65105","155953","77969","77984","102.2","高雄市"
"1039","鳳山一","43","1113","68380","178644","87826","90818","102.2","高雄市"
"1040","鳳山二","35","1007","63851","171803","85613","86190","102.2","高雄市"
"1041","林園區","24","525","25015","70434","35974","34460","102.2","高雄市"
"1042","大寮區","25","747","39741","109839","56809","53030","102.2","高雄市"
"1043","大樹區","18","376","13152","43370","22413","20957","102.2","高雄市"
"1044","大社區","9","175","12114","33831","17313","16518","102.2","高雄市"
"1045","仁武區","16","389","28464","77612","39823","37789","102.2","高雄市"
"1046","鳥松區","7","192","17233","43672","22142","21530","102.2","高雄市"
"1047","岡山區","33","540","34036","97683","48781","48902","102.2","高雄市"
"1048","橋頭區","17","359","13019","36977","18865","18112","102.2","高雄市"
"1049","燕巢區","11","289","10200","30732","16329","14403","102.2","高雄市"
"1050","田寮區","10","154","3476","7814","4364","3450","102.2","高雄市"
"1051","阿蓮區","12","276","9315","30001","15140","14861","102.2","高雄市"
"1052","路竹區","20","395","16337","53138","27151","25987","102.2","高雄市"
"1053","湖內區","14","260","10039","29127","14975","14152","102.2","高雄市"
"1054","茄萣區","15","339","10304","30942","16058","14884","102.2","高雄市"
"1055","永安區","6","81","5826","14133","7153","6980","102.2","高雄市"
"1056","彌陀區","12","227","6695","20057","10415","9642","102.2","高雄市"
"1057","梓官區","15","286","12298","36480","18919","17561","102.2","高雄市"
"1058","旗山區","21","381","13906","38987","20222","18765","102.2","高雄市"
"1059","美濃區","19","389","14393","42098","21978","20120","102.2","高雄市"
"1060","六龜區","12","221","5719","14162","7651","6511","102.2","高雄市"
"1061","甲仙區","7","103","2396","6594","3505","3089","102.2","高雄市"
"1062","杉林區","7","138","4828","12617","6886","5731","102.2","高雄市"
"1063","內門區","18","207","5061","15479","8448","7031","102.2","高雄市"
"1064","茂林區","3","19","577","1831","923","908","102.2","高雄市"
"1065","桃源區","8","39","1348","4531","2392","2139","102.2","高雄市"
"1066","那瑪夏區","3","20","878","3174","1640","1534","102.2","高雄市"
"1067","高雄市","893","17682","1048194","2778936","1387382","1391554","102.3","高雄市"
"1068","鹽埕區","21","232","11013","26185","13068","13117","102.3","高雄市"
"1069","鼓山區","38","722","54073","134068","65218","68850","102.3","高雄市"
"1070","左營區","40","760","75837","195164","95339","99825","102.3","高雄市"
"1071","楠梓區","37","803","64078","176194","87197","88997","102.3","高雄市"
"1072","三民一","41","662","33006","83601","41531","42070","102.3","高雄市"
"1073","三民二","45","1082","100289","265882","128808","137074","102.3","高雄市"
"1074","新興區","32","456","22782","53666","25948","27718","102.3","高雄市"
"1075","前金區","20","263","12560","28210","13712","14498","102.3","高雄市"
"1076","苓雅區","69","1248","72112","179182","86909","92273","102.3","高雄市"
"1077","前鎮區","59","1298","77234","195572","96822","98750","102.3","高雄市"
"1078","旗津區","13","212","10969","29301","15185","14116","102.3","高雄市"
"1079","小港區","38","697","65138","155928","77926","78002","102.3","高雄市"
"1080","鳳山一","43","1113","68487","178817","87866","90951","102.3","高雄市"
"1081","鳳山二","35","1007","63950","171997","85707","86290","102.3","高雄市"
"1082","林園區","24","525","25052","70433","35963","34470","102.3","高雄市"
"1083","大寮區","25","747","39782","109854","56815","53039","102.3","高雄市"
"1084","大樹區","18","376","13149","43360","22408","20952","102.3","高雄市"
"1085","大社區","9","175","12122","33828","17306","16522","102.3","高雄市"
"1086","仁武區","16","389","28550","77772","39902","37870","102.3","高雄市"
"1087","鳥松區","7","192","17240","43666","22154","21512","102.3","高雄市"
"1088","岡山區","33","540","34066","97676","48741","48935","102.3","高雄市"
"1089","橋頭區","17","359","13029","36979","18869","18110","102.3","高雄市"
"1090","燕巢區","11","289","10219","30732","16333","14399","102.3","高雄市"
"1091","田寮區","10","154","3475","7818","4356","3462","102.3","高雄市"
"1092","阿蓮區","12","276","9323","29954","15119","14835","102.3","高雄市"
"1093","路竹區","20","395","16368","53161","27176","25985","102.3","高雄市"
"1094","湖內區","14","260","10053","29103","14972","14131","102.3","高雄市"
"1095","茄萣區","15","339","10302","30896","16043","14853","102.3","高雄市"
"1096","永安區","6","81","5828","14130","7141","6989","102.3","高雄市"
"1097","彌陀區","12","227","6692","20040","10405","9635","102.3","高雄市"
"1098","梓官區","15","286","12315","36475","18896","17579","102.3","高雄市"
"1099","旗山區","21","381","13903","38955","20201","18754","102.3","高雄市"
"1100","美濃區","19","389","14408","42073","21974","20099","102.3","高雄市"
"1101","六龜區","12","221","5712","14136","7644","6492","102.3","高雄市"
"1102","甲仙區","7","103","2389","6559","3486","3073","102.3","高雄市"
"1103","杉林區","7","138","4829","12616","6877","5739","102.3","高雄市"
"1104","內門區","18","207","5061","15458","8434","7024","102.3","高雄市"
"1105","茂林區","3","19","577","1825","920","905","102.3","高雄市"
"1106","桃源區","8","39","1347","4514","2378","2136","102.3","高雄市"
"1107","那瑪夏區","3","20","875","3156","1633","1523","102.3","高雄市"
"1108","高雄市","893","17682","1048943","2778793","1387120","1391673","102.4","高雄市"
"1109","鹽埕區","21","232","10986","26139","13046","13093","102.4","高雄市"
"1110","鼓山區","38","722","54115","134098","65203","68895","102.4","高雄市"
"1111","左營區","40","760","75871","195175","95327","99848","102.4","高雄市"
"1112","楠梓區","37","803","64173","176328","87262","89066","102.4","高雄市"
"1113","三民一","41","660","32977","83560","41497","42063","102.4","高雄市"
"1114","三民二","45","1084","100378","265886","128794","137092","102.4","高雄市"
"1115","新興區","32","456","22768","53568","25900","27668","102.4","高雄市"
"1116","前金區","20","263","12561","28158","13667","14491","102.4","高雄市"
"1117","苓雅區","69","1248","72135","179016","86822","92194","102.4","高雄市"
"1118","前鎮區","59","1298","77245","195417","96745","98672","102.4","高雄市"
"1119","旗津區","13","212","10968","29216","15150","14066","102.4","高雄市"
"1120","小港區","38","697","65191","155982","77948","78034","102.4","高雄市"
"1121","鳳山一","43","1113","68620","179003","87923","91080","102.4","高雄市"
"1122","鳳山二","35","1007","64072","172088","85703","86385","102.4","高雄市"
"1123","林園區","24","525","25056","70455","35987","34468","102.4","高雄市"
"1124","大寮區","25","747","39847","109928","56855","53073","102.4","高雄市"
"1125","大樹區","18","376","13162","43356","22411","20945","102.4","高雄市"
"1126","大社區","9","175","12155","33852","17328","16524","102.4","高雄市"
"1127","仁武區","16","389","28644","78021","40016","38005","102.4","高雄市"
"1128","鳥松區","7","192","17247","43641","22165","21476","102.4","高雄市"
"1129","岡山區","33","540","34076","97725","48759","48966","102.4","高雄市"
"1130","橋頭區","17","359","13029","36938","18855","18083","102.4","高雄市"
"1131","燕巢區","11","289","10221","30690","16317","14373","102.4","高雄市"
"1132","田寮區","10","154","3461","7810","4354","3456","102.4","高雄市"
"1133","阿蓮區","12","276","9322","29926","15104","14822","102.4","高雄市"
"1134","路竹區","20","395","16363","53133","27159","25974","102.4","高雄市"
"1135","湖內區","14","260","10063","29117","14974","14143","102.4","高雄市"
"1136","茄萣區","15","339","10309","30879","16028","14851","102.4","高雄市"
"1137","永安區","6","81","5827","14112","7128","6984","102.4","高雄市"
"1138","彌陀區","12","227","6690","20014","10394","9620","102.4","高雄市"
"1139","梓官區","15","286","12315","36431","18870","17561","102.4","高雄市"
"1140","旗山區","21","381","13898","38927","20179","18748","102.4","高雄市"
"1141","美濃區","19","389","14410","42027","21933","20094","102.4","高雄市"
"1142","六龜區","12","221","5711","14099","7623","6476","102.4","高雄市"
"1143","甲仙區","7","103","2387","6551","3482","3069","102.4","高雄市"
"1144","杉林區","7","138","4828","12623","6875","5748","102.4","高雄市"
"1145","內門區","18","207","5065","15442","8423","7019","102.4","高雄市"
"1146","茂林區","3","19","576","1814","914","900","102.4","高雄市"
"1147","桃源區","8","39","1346","4489","2363","2126","102.4","高雄市"
"1148","那瑪夏區","3","20","875","3159","1637","1522","102.4","高雄市"
"1149","高雄市","893","17682","1049834","2778920","1386915","1392005","102.5","高雄市"
"1150","鹽埕區","21","232","10978","26089","13021","13068","102.5","高雄市"
"1151","鼓山區","38","722","54184","134216","65250","68966","102.5","高雄市"
"1152","左營區","40","760","75975","195339","95375","99964","102.5","高雄市"
"1153","楠梓區","37","803","64279","176511","87353","89158","102.5","高雄市"
"1154","三民一","41","660","32976","83446","41420","42026","102.5","高雄市"
"1155","三民二","45","1084","100462","265837","128731","137106","102.5","高雄市"
"1156","新興區","32","456","22759","53510","25856","27654","102.5","高雄市"
"1157","前金區","20","263","12577","28174","13668","14506","102.5","高雄市"
"1158","苓雅區","69","1248","72111","178755","86660","92095","102.5","高雄市"
"1159","前鎮區","59","1298","77284","195380","96672","98708","102.5","高雄市"
"1160","旗津區","13","212","10953","29133","15093","14040","102.5","高雄市"
"1161","小港區","38","697","65255","156083","78007","78076","102.5","高雄市"
"1162","鳳山一","43","1113","68714","179128","87980","91148","102.5","高雄市"
"1163","鳳山二","35","1007","64171","172227","85739","86488","102.5","高雄市"
"1164","林園區","24","525","25095","70453","35980","34473","102.5","高雄市"
"1165","大寮區","25","747","39907","109937","56865","53072","102.5","高雄市"
"1166","大樹區","18","376","13169","43343","22389","20954","102.5","高雄市"
"1167","大社區","9","175","12155","33851","17337","16514","102.5","高雄市"
"1168","仁武區","16","389","28713","78137","40070","38067","102.5","高雄市"
"1169","鳥松區","7","192","17253","43640","22172","21468","102.5","高雄市"
"1170","岡山區","33","540","34111","97808","48789","49019","102.5","高雄市"
"1171","橋頭區","17","359","13032","36916","18836","18080","102.5","高雄市"
"1172","燕巢區","11","289","10238","30671","16310","14361","102.5","高雄市"
"1173","田寮區","10","154","3456","7800","4347","3453","102.5","高雄市"
"1174","阿蓮區","12","276","9329","29909","15099","14810","102.5","高雄市"
"1175","路竹區","20","395","16380","53111","27143","25968","102.5","高雄市"
"1176","湖內區","14","260","10080","29168","14995","14173","102.5","高雄市"
"1177","茄萣區","15","339","10324","30880","16036","14844","102.5","高雄市"
"1178","永安區","6","81","5830","14101","7134","6967","102.5","高雄市"
"1179","彌陀區","12","227","6682","19991","10382","9609","102.5","高雄市"
"1180","梓官區","15","286","12322","36416","18861","17555","102.5","高雄市"
"1181","旗山區","21","381","13897","38879","20152","18727","102.5","高雄市"
"1182","美濃區","19","389","14400","41976","21909","20067","102.5","高雄市"
"1183","六龜區","12","221","5708","14070","7609","6461","102.5","高雄市"
"1184","甲仙區","7","103","2383","6537","3473","3064","102.5","高雄市"
"1185","杉林區","7","138","4828","12618","6873","5745","102.5","高雄市"
"1186","內門區","18","207","5066","15426","8413","7013","102.5","高雄市"
"1187","茂林區","3","19","578","1814","918","896","102.5","高雄市"
"1188","桃源區","8","39","1345","4483","2364","2119","102.5","高雄市"
"1189","那瑪夏區","3","20","875","3157","1634","1523","102.5","高雄市"
"1190","高雄市","893","17682","1050752","2779092","1386830","1392262","102.6","高雄市"
"1191","鹽埕區","21","232","10975","26068","13016","13052","102.6","高雄市"
"1192","鼓山區","38","722","54299","134371","65327","69044","102.6","高雄市"
"1193","左營區","40","760","76005","195367","95380","99987","102.6","高雄市"
"1194","楠梓區","37","803","64378","176597","87366","89231","102.6","高雄市"
"1195","三民一","41","660","32980","83358","41348","42010","102.6","高雄市"
"1196","三民二","45","1084","100534","265845","128732","137113","102.6","高雄市"
"1197","新興區","32","456","22763","53512","25843","27669","102.6","高雄市"
"1198","前金區","20","263","12569","28177","13670","14507","102.6","高雄市"
"1199","苓雅區","69","1248","72163","178611","86559","92052","102.6","高雄市"
"1200","前鎮區","59","1298","77247","195196","96585","98611","102.6","高雄市"
"1201","旗津區","13","212","10951","29116","15074","14042","102.6","高雄市"
"1202","小港區","38","697","65356","156118","78016","78102","102.6","高雄市"
"1203","鳳山一","43","1113","68823","179257","88033","91224","102.6","高雄市"
"1204","鳳山二","35","1007","64268","172364","85798","86566","102.6","高雄市"
"1205","林園區","24","525","25105","70388","35945","34443","102.6","高雄市"
"1206","大寮區","25","747","39957","109955","56856","53099","102.6","高雄市"
"1207","大樹區","18","376","13171","43354","22390","20964","102.6","高雄市"
"1208","大社區","9","175","12169","33839","17342","16497","102.6","高雄市"
"1209","仁武區","16","389","28811","78321","40153","38168","102.6","高雄市"
"1210","鳥松區","7","192","17264","43665","22174","21491","102.6","高雄市"
"1211","岡山區","33","540","34142","97868","48812","49056","102.6","高雄市"
"1212","橋頭區","17","359","13045","36941","18852","18089","102.6","高雄市"
"1213","燕巢區","11","289","10250","30666","16311","14355","102.6","高雄市"
"1214","田寮區","10","154","3457","7794","4343","3451","102.6","高雄市"
"1215","阿蓮區","12","276","9333","29883","15082","14801","102.6","高雄市"
"1216","路竹區","20","395","16394","53103","27128","25975","102.6","高雄市"
"1217","湖內區","14","260","10090","29155","14995","14160","102.6","高雄市"
"1218","茄萣區","15","339","10336","30882","16054","14828","102.6","高雄市"
"1219","永安區","6","81","5824","14106","7126","6980","102.6","高雄市"
"1220","彌陀區","12","227","6688","19983","10374","9609","102.6","高雄市"
"1221","梓官區","15","286","12333","36424","18866","17558","102.6","高雄市"
"1222","旗山區","21","381","13899","38818","20133","18685","102.6","高雄市"
"1223","美濃區","19","389","14399","41950","21904","20046","102.6","高雄市"
"1224","六龜區","12","221","5702","14063","7601","6462","102.6","高雄市"
"1225","甲仙區","7","103","2382","6523","3467","3056","102.6","高雄市"
"1226","杉林區","7","138","4828","12600","6863","5737","102.6","高雄市"
"1227","內門區","18","207","5065","15414","8400","7014","102.6","高雄市"
"1228","茂林區","3","19","579","1815","920","895","102.6","高雄市"
"1229","桃源區","8","39","1343","4460","2351","2109","102.6","高雄市"
"1230","那瑪夏區","3","20","875","3165","1641","1524","102.6","高雄市"
"1231","高雄市","893","17682","1052035","2779416","1386731","1392685","102.7","高雄市"
"1232","鹽埕區","21","232","10975","26021","12984","13037","102.7","高雄市"
"1233","鼓山區","38","722","54408","134461","65351","69110","102.7","高雄市"
"1234","左營區","40","760","76091","195371","95365","100006","102.7","高雄市"
"1235","楠梓區","37","803","64544","176776","87467","89309","102.7","高雄市"
"1236","三民一","41","660","32990","83324","41347","41977","102.7","高雄市"
"1237","三民二","45","1084","100657","265750","128675","137075","102.7","高雄市"
"1238","新興區","32","456","22787","53471","25825","27646","102.7","高雄市"
"1239","前金區","20","263","12581","28194","13669","14525","102.7","高雄市"
"1240","苓雅區","69","1248","72154","178429","86456","91973","102.7","高雄市"
"1241","前鎮區","59","1298","77360","195259","96582","98677","102.7","高雄市"
"1242","旗津區","13","212","10951","29083","15056","14027","102.7","高雄市"
"1243","小港區","38","697","65388","156125","78022","78103","102.7","高雄市"
"1244","鳳山一","43","1113","68930","179308","88022","91286","102.7","高雄市"
"1245","鳳山二","35","1007","64380","172552","85889","86663","102.7","高雄市"
"1246","林園區","24","525","25123","70404","35941","34463","102.7","高雄市"
"1247","大寮區","25","747","40054","110037","56873","53164","102.7","高雄市"
"1248","大樹區","18","376","13188","43327","22372","20955","102.7","高雄市"
"1249","大社區","9","175","12204","33859","17354","16505","102.7","高雄市"
"1250","仁武區","16","389","28890","78485","40203","38282","102.7","高雄市"
"1251","鳥松區","7","192","17296","43716","22201","21515","102.7","高雄市"
"1252","岡山區","33","540","34183","97847","48814","49033","102.7","高雄市"
"1253","橋頭區","17","359","13066","36991","18865","18126","102.7","高雄市"
"1254","燕巢區","11","289","10252","30652","16308","14344","102.7","高雄市"
"1255","田寮區","10","154","3455","7787","4331","3456","102.7","高雄市"
"1256","阿蓮區","12","276","9343","29872","15069","14803","102.7","高雄市"
"1257","路竹區","20","395","16403","53072","27105","25967","102.7","高雄市"
"1258","湖內區","14","260","10085","29173","14996","14177","102.7","高雄市"
"1259","茄萣區","15","339","10351","30876","16041","14835","102.7","高雄市"
"1260","永安區","6","81","5827","14151","7147","7004","102.7","高雄市"
"1261","彌陀區","12","227","6684","19955","10348","9607","102.7","高雄市"
"1262","梓官區","15","286","12350","36422","18857","17565","102.7","高雄市"
"1263","旗山區","21","381","13891","38788","20116","18672","102.7","高雄市"
"1264","美濃區","19","389","14415","41915","21881","20034","102.7","高雄市"
"1265","六龜區","12","221","5695","14018","7572","6446","102.7","高雄市"
"1266","甲仙區","7","103","2386","6509","3463","3046","102.7","高雄市"
"1267","杉林區","7","138","4834","12606","6864","5742","102.7","高雄市"
"1268","內門區","18","207","5065","15404","8393","7011","102.7","高雄市"
"1269","茂林區","3","19","581","1817","919","898","102.7","高雄市"
"1270","桃源區","8","39","1344","4450","2346","2104","102.7","高雄市"
"1271","那瑪夏區","3","20","874","3159","1642","1517","102.7","高雄市"
"1272","高雄市","893","17682","1053515","2779448","1386529","1392919","102.8","高雄市"
"1273","鹽埕區","21","232","10999","26015","12977","13038","102.8","高雄市"
"1274","鼓山區","38","722","54559","134559","65373","69186","102.8","高雄市"
"1275","左營區","40","760","76198","195471","95387","100084","102.8","高雄市"
"1276","楠梓區","37","803","64676","176911","87547","89364","102.8","高雄市"
"1277","三民一","41","660","33000","83306","41337","41969","102.8","高雄市"
"1278","三民二","45","1084","100772","265529","128497","137032","102.8","高雄市"
"1279","新興區","32","456","22782","53319","25752","27567","102.8","高雄市"
"1280","前金區","20","263","12589","28157","13647","14510","102.8","高雄市"
"1281","苓雅區","69","1248","72247","178254","86376","91878","102.8","高雄市"
"1282","前鎮區","59","1298","77404","195202","96502","98700","102.8","高雄市"
"1283","旗津區","13","212","10944","29054","15049","14005","102.8","高雄市"
"1284","小港區","38","697","65423","156071","78002","78069","102.8","高雄市"
"1285","鳳山一","43","1113","69114","179394","88029","91365","102.8","高雄市"
"1286","鳳山二","35","1007","64506","172674","85938","86736","102.8","高雄市"
"1287","林園區","24","525","25141","70378","35908","34470","102.8","高雄市"
"1288","大寮區","25","747","40125","110176","56926","53250","102.8","高雄市"
"1289","大樹區","18","376","13209","43341","22371","20970","102.8","高雄市"
"1290","大社區","9","175","12247","33908","17375","16533","102.8","高雄市"
"1291","仁武區","16","389","29035","78672","40308","38364","102.8","高雄市"
"1292","鳥松區","7","192","17313","43767","22247","21520","102.8","高雄市"
"1293","岡山區","33","540","34227","97895","48839","49056","102.8","高雄市"
"1294","橋頭區","17","359","13084","36994","18876","18118","102.8","高雄市"
"1295","燕巢區","11","289","10246","30642","16308","14334","102.8","高雄市"
"1296","田寮區","10","154","3452","7772","4328","3444","102.8","高雄市"
"1297","阿蓮區","12","276","9358","29859","15062","14797","102.8","高雄市"
"1298","路竹區","20","395","16424","53076","27108","25968","102.8","高雄市"
"1299","湖內區","14","260","10117","29198","15012","14186","102.8","高雄市"
"1300","茄萣區","15","339","10348","30866","16026","14840","102.8","高雄市"
"1301","永安區","6","81","5829","14156","7143","7013","102.8","高雄市"
"1302","彌陀區","12","227","6688","19964","10354","9610","102.8","高雄市"
"1303","梓官區","15","286","12363","36406","18840","17566","102.8","高雄市"
"1304","旗山區","21","381","13900","38733","20090","18643","102.8","高雄市"
"1305","美濃區","19","389","14429","41861","21853","20008","102.8","高雄市"
"1306","六龜區","12","221","5693","13990","7559","6431","102.8","高雄市"
"1307","甲仙區","7","103","2383","6487","3453","3034","102.8","高雄市"
"1308","杉林區","7","138","4833","12602","6862","5740","102.8","高雄市"
"1309","內門區","18","207","5069","15396","8379","7017","102.8","高雄市"
"1310","茂林區","3","19","581","1817","919","898","102.8","高雄市"
"1311","桃源區","8","39","1338","4427","2336","2091","102.8","高雄市"
"1312","那瑪夏區","3","20","870","3149","1634","1515","102.8","高雄市"
"1313","高雄市","893","17682","1055340","2779246","1386293","1392953","102.9","高雄市"
"1314","鹽埕區","21","232","10985","25931","12942","12989","102.9","高雄市"
"1315","鼓山區","38","722","54777","134771","65503","69268","102.9","高雄市"
"1316","左營區","40","760","76324","195389","95308","100081","102.9","高雄市"
"1317","楠梓區","37","803","64927","177191","87673","89518","102.9","高雄市"
"1318","三民一","41","660","33000","83149","41262","41887","102.9","高雄市"
"1319","三民二","45","1084","100955","265559","128468","137091","102.9","高雄市"
"1320","新興區","32","456","22813","53261","25723","27538","102.9","高雄市"
"1321","前金區","20","263","12591","28090","13611","14479","102.9","高雄市"
"1322","苓雅區","69","1248","72351","178009","86260","91749","102.9","高雄市"
"1323","前鎮區","59","1298","77565","195071","96432","98639","102.9","高雄市"
"1324","旗津區","13","212","10953","29050","15040","14010","102.9","高雄市"
"1325","小港區","38","697","65514","156017","77982","78035","102.9","高雄市"
"1326","鳳山一","43","1113","69302","179465","88059","91406","102.9","高雄市"
"1327","鳳山二","35","1007","64618","172842","85992","86850","102.9","高雄市"
"1328","林園區","24","525","25150","70360","35891","34469","102.9","高雄市"
"1329","大寮區","25","747","40187","110288","56985","53303","102.9","高雄市"
"1330","大樹區","18","376","13220","43319","22363","20956","102.9","高雄市"
"1331","大社區","9","175","12276","33961","17390","16571","102.9","高雄市"
"1332","仁武區","16","389","29183","78863","40419","38444","102.9","高雄市"
"1333","鳥松區","7","192","17345","43749","22235","21514","102.9","高雄市"
"1334","岡山區","33","540","34251","97854","48813","49041","102.9","高雄市"
"1335","橋頭區","17","359","13090","36999","18879","18120","102.9","高雄市"
"1336","燕巢區","11","289","10257","30595","16270","14325","102.9","高雄市"
"1337","田寮區","10","154","3451","7758","4317","3441","102.9","高雄市"
"1338","阿蓮區","12","276","9371","29852","15057","14795","102.9","高雄市"
"1339","路竹區","20","395","16440","53051","27107","25944","102.9","高雄市"
"1340","湖內區","14","260","10127","29188","14998","14190","102.9","高雄市"
"1341","茄萣區","15","339","10352","30852","16012","14840","102.9","高雄市"
"1342","永安區","6","81","5825","14137","7133","7004","102.9","高雄市"
"1343","彌陀區","12","227","6682","19949","10354","9595","102.9","高雄市"
"1344","梓官區","15","286","12369","36391","18830","17561","102.9","高雄市"
"1345","旗山區","21","381","13890","38678","20054","18624","102.9","高雄市"
"1346","美濃區","19","389","14438","41770","21800","19970","102.9","高雄市"
"1347","六龜區","12","221","5698","13968","7544","6424","102.9","高雄市"
"1348","甲仙區","7","103","2379","6480","3452","3028","102.9","高雄市"
"1349","杉林區","7","138","4826","12603","6868","5735","102.9","高雄市"
"1350","內門區","18","207","5075","15389","8378","7011","102.9","高雄市"
"1351","茂林區","3","19","581","1820","918","902","102.9","高雄市"
"1352","桃源區","8","39","1335","4433","2338","2095","102.9","高雄市"
"1353","那瑪夏區","3","20","867","3144","1633","1511","102.9","高雄市"
"1354","高雄市","893","17682","1055414","2779427","1386156","1393271","102.10","高雄市"
"1355","鹽埕區","21","232","10987","25904","12916","12988","102.10","高雄市"
"1356","鼓山區","38","722","54786","134859","65570","69289","102.10","高雄市"
"1357","左營區","40","760","76338","195385","95284","100101","102.10","高雄市"
"1358","楠梓區","37","803","64965","177339","87709","89630","102.10","高雄市"
"1359","三民一","41","660","32976","83089","41245","41844","102.10","高雄市"
"1360","三民二","45","1084","100959","265510","128433","137077","102.10","高雄市"
"1361","新興區","32","456","22791","53232","25716","27516","102.10","高雄市"
"1362","前金區","20","263","12571","28021","13567","14454","102.10","高雄市"
"1363","苓雅區","69","1248","72267","177892","86203","91689","102.10","高雄市"
"1364","前鎮區","59","1298","77565","195031","96399","98632","102.10","高雄市"
"1365","旗津區","13","212","10950","29073","15045","14028","102.10","高雄市"
"1366","小港區","38","697","65509","156056","78007","78049","102.10","高雄市"
"1367","鳳山一","43","1113","69293","179435","88041","91394","102.10","高雄市"
"1368","鳳山二","35","1007","64663","172974","86043","86931","102.10","高雄市"
"1369","林園區","24","525","25165","70368","35881","34487","102.10","高雄市"
"1370","大寮區","25","747","40210","110368","56986","53382","102.10","高雄市"
"1371","大樹區","18","376","13228","43407","22361","21046","102.10","高雄市"
"1372","大社區","9","175","12290","33975","17394","16581","102.10","高雄市"
"1373","仁武區","16","389","29272","79081","40504","38577","102.10","高雄市"
"1374","鳥松區","7","192","17345","43775","22251","21524","102.10","高雄市"
"1375","岡山區","33","540","34234","97833","48810","49023","102.10","高雄市"
"1376","橋頭區","17","359","13085","36994","18874","18120","102.10","高雄市"
"1377","燕巢區","11","289","10251","30578","16261","14317","102.10","高雄市"
"1378","田寮區","10","154","3448","7752","4312","3440","102.10","高雄市"
"1379","阿蓮區","12","276","9368","29834","15051","14783","102.10","高雄市"
"1380","路竹區","20","395","16442","53011","27077","25934","102.10","高雄市"
"1381","湖內區","14","260","10138","29190","14993","14197","102.10","高雄市"
"1382","茄萣區","15","339","10360","30876","16012","14864","102.10","高雄市"
"1383","永安區","6","81","5823","14141","7131","7010","102.10","高雄市"
"1384","彌陀區","12","227","6685","19934","10346","9588","102.10","高雄市"
"1385","梓官區","15","286","12360","36371","18811","17560","102.10","高雄市"
"1386","旗山區","21","381","13893","38623","20027","18596","102.10","高雄市"
"1387","美濃區","19","389","14439","41713","21775","19938","102.10","高雄市"
"1388","六龜區","12","221","5704","13960","7541","6419","102.10","高雄市"
"1389","甲仙區","7","103","2379","6467","3442","3025","102.10","高雄市"
"1390","杉林區","7","138","4821","12602","6870","5732","102.10","高雄市"
"1391","內門區","18","207","5073","15381","8380","7001","102.10","高雄市"
"1392","茂林區","3","19","580","1820","918","902","102.10","高雄市"
"1393","桃源區","8","39","1335","4426","2338","2088","102.10","高雄市"
"1394","那瑪夏區","3","20","866","3147","1632","1515","102.10","高雄市"
"1395","高雄市","893","17688","1055962","2779563","1385984","1393579","102.11","高雄市"
"1396","鹽埕區","21","232","10997","25904","12918","12986","102.11","高雄市"
"1397","鼓山區","38","722","54867","135022","65627","69395","102.11","高雄市"
"1398","左營區","40","760","76357","195373","95237","100136","102.11","高雄市"
"1399","楠梓區","37","803","65028","177477","87768","89709","102.11","高雄市"
"1400","三民一","41","660","32990","83108","41250","41858","102.11","高雄市"
"1401","三民二","45","1084","101006","265487","128446","137041","102.11","高雄市"
"1402","新興區","32","456","22755","53158","25667","27491","102.11","高雄市"
"1403","前金區","20","263","12583","28050","13568","14482","102.11","高雄市"
"1404","苓雅區","69","1248","72272","177796","86151","91645","102.11","高雄市"
"1405","前鎮區","59","1298","77553","194866","96302","98564","102.11","高雄市"
"1406","旗津區","13","212","10957","29061","15040","14021","102.11","高雄市"
"1407","小港區","38","697","65536","156101","77990","78111","102.11","高雄市"
"1408","鳳山一","43","1119","69281","179338","87997","91341","102.11","高雄市"
"1409","鳳山二","35","1007","64725","173092","86066","87026","102.11","高雄市"
"1410","林園區","24","525","25193","70375","35877","34498","102.11","高雄市"
"1411","大寮區","25","747","40248","110392","56968","53424","102.11","高雄市"
"1412","大樹區","18","376","13234","43417","22363","21054","102.11","高雄市"
"1413","大社區","9","175","12350","34031","17419","16612","102.11","高雄市"
"1414","仁武區","16","389","29352","79230","40580","38650","102.11","高雄市"
"1415","鳥松區","7","192","17346","43782","22262","21520","102.11","高雄市"
"1416","岡山區","33","540","34253","97838","48816","49022","102.11","高雄市"
"1417","橋頭區","17","359","13094","36997","18878","18119","102.11","高雄市"
"1418","燕巢區","11","289","10263","30562","16244","14318","102.11","高雄市"
"1419","田寮區","10","154","3447","7747","4309","3438","102.11","高雄市"
"1420","阿蓮區","12","276","9364","29801","15032","14769","102.11","高雄市"
"1421","路竹區","20","395","16445","53004","27077","25927","102.11","高雄市"
"1422","湖內區","14","260","10138","29195","14991","14204","102.11","高雄市"
"1423","茄萣區","15","339","10360","30890","16022","14868","102.11","高雄市"
"1424","永安區","6","81","5827","14134","7120","7014","102.11","高雄市"
"1425","彌陀區","12","227","6689","19937","10353","9584","102.11","高雄市"
"1426","梓官區","15","286","12358","36372","18810","17562","102.11","高雄市"
"1427","旗山區","21","381","13889","38597","20003","18594","102.11","高雄市"
"1428","美濃區","19","389","14456","41700","21758","19942","102.11","高雄市"
"1429","六龜區","12","221","5698","13937","7528","6409","102.11","高雄市"
"1430","甲仙區","7","103","2382","6452","3433","3019","102.11","高雄市"
"1431","杉林區","7","138","4820","12591","6867","5724","102.11","高雄市"
"1432","內門區","18","207","5068","15364","8364","7000","102.11","高雄市"
"1433","茂林區","3","19","578","1818","918","900","102.11","高雄市"
"1434","桃源區","8","39","1337","4423","2339","2084","102.11","高雄市"
"1435","那瑪夏區","3","20","866","3144","1626","1518","102.11","高雄市"
"1436","高雄市","893","17688","1056421","2779877","1385895","1393982","102.12","高雄市"
"1437","鹽埕區","21","232","10981","25847","12892","12955","102.12","高雄市"
"1438","鼓山區","38","722","54918","135102","65677","69425","102.12","高雄市"
"1439","左營區","40","760","76391","195436","95262","100174","102.12","高雄市"
"1440","楠梓區","37","803","65087","177579","87812","89767","102.12","高雄市"
"1441","三民一","41","660","33009","83080","41242","41838","102.12","高雄市"
"1442","三民二","45","1084","101010","265408","128437","136971","102.12","高雄市"
"1443","新興區","32","456","22748","53170","25669","27501","102.12","高雄市"
"1444","前金區","20","263","12578","28038","13554","14484","102.12","高雄市"
"1445","苓雅區","69","1248","72273","177716","86060","91656","102.12","高雄市"
"1446","前鎮區","59","1298","77627","194835","96310","98525","102.12","高雄市"
"1447","旗津區","13","212","10962","29040","15020","14020","102.12","高雄市"
"1448","小港區","38","697","65553","156115","77933","78182","102.12","高雄市"
"1449","鳳山一","43","1119","69199","179240","87903","91337","102.12","高雄市"
"1450","鳳山二","35","1007","64836","173334","86146","87188","102.12","高雄市"
"1451","林園區","24","525","25218","70436","35925","34511","102.12","高雄市"
"1452","大寮區","25","747","40291","110449","56969","53480","102.12","高雄市"
"1453","大樹區","18","376","13235","43418","22349","21069","102.12","高雄市"
"1454","大社區","9","175","12402","34097","17445","16652","102.12","高雄市"
"1455","仁武區","16","389","29426","79392","40668","38724","102.12","高雄市"
"1456","鳥松區","7","192","17354","43781","22251","21530","102.12","高雄市"
"1457","岡山區","33","540","34234","97800","48780","49020","102.12","高雄市"
"1458","橋頭區","17","359","13084","37010","18879","18131","102.12","高雄市"
"1459","燕巢區","11","289","10259","30542","16223","14319","102.12","高雄市"
"1460","田寮區","10","154","3447","7732","4305","3427","102.12","高雄市"
"1461","阿蓮區","12","276","9365","29795","15028","14767","102.12","高雄市"
"1462","路竹區","20","395","16472","53036","27099","25937","102.12","高雄市"
"1463","湖內區","14","260","10146","29203","14984","14219","102.12","高雄市"
"1464","茄萣區","15","339","10373","30868","16013","14855","102.12","高雄市"
"1465","永安區","6","81","5828","14138","7117","7021","102.12","高雄市"
"1466","彌陀區","12","227","6687","19920","10335","9585","102.12","高雄市"
"1467","梓官區","15","286","12355","36381","18808","17573","102.12","高雄市"
"1468","旗山區","21","381","13874","38563","19989","18574","102.12","高雄市"
"1469","美濃區","19","389","14455","41668","21743","19925","102.12","高雄市"
"1470","六龜區","12","221","5699","13943","7534","6409","102.12","高雄市"
"1471","甲仙區","7","103","2377","6444","3431","3013","102.12","高雄市"
"1472","杉林區","7","138","4823","12587","6862","5725","102.12","高雄市"
"1473","內門區","18","207","5071","15351","8355","6996","102.12","高雄市"
"1474","茂林區","3","19","579","1832","927","905","102.12","高雄市"
"1475","桃源區","8","39","1330","4406","2330","2076","102.12","高雄市"
"1476","那瑪夏區","3","20","865","3145","1629","1516","102.12","高雄市"
"1477","高雄市","893","17688","1056653","2779790","1385726","1394064","103.1","高雄市"
"1478","鹽埕區","21","232","10979","25846","12882","12964","103.1","高雄市"
"1479","鼓山區","38","722","54920","135170","65744","69426","103.1","高雄市"
"1480","左營區","40","760","76413","195436","95181","100255","103.1","高雄市"
"1481","楠梓區","37","803","65171","177684","87884","89800","103.1","高雄市"
"1482","三民一","41","660","32989","83005","41202","41803","103.1","高雄市"
"1483","三民二","45","1084","101080","265403","128396","137007","103.1","高雄市"
"1484","新興區","32","456","22723","53134","25652","27482","103.1","高雄市"
"1485","前金區","20","263","12558","27987","13520","14467","103.1","高雄市"
"1486","苓雅區","69","1248","72215","177543","85990","91553","103.1","高雄市"
"1487","前鎮區","59","1298","77594","194681","96258","98423","103.1","高雄市"
"1488","旗津區","13","212","10958","29000","15005","13995","103.1","高雄市"
"1489","小港區","38","697","65576","156187","77953","78234","103.1","高雄市"
"1490","鳳山一","43","1119","69172","179229","87873","91356","103.1","高雄市"
"1491","鳳山二","35","1007","64897","173539","86261","87278","103.1","高雄市"
"1492","林園區","24","525","25253","70452","35929","34523","103.1","高雄市"
"1493","大寮區","25","747","40322","110487","56992","53495","103.1","高雄市"
"1494","大樹區","18","376","13222","43356","22307","21049","103.1","高雄市"
"1495","大社區","9","175","12435","34121","17466","16655","103.1","高雄市"
"1496","仁武區","16","389","29485","79487","40705","38782","103.1","高雄市"
"1497","鳥松區","7","192","17358","43812","22266","21546","103.1","高雄市"
"1498","岡山區","33","540","34251","97834","48761","49073","103.1","高雄市"
"1499","橋頭區","17","359","13079","37047","18905","18142","103.1","高雄市"
"1500","燕巢區","11","289","10253","30524","16218","14306","103.1","高雄市"
"1501","田寮區","10","154","3443","7724","4301","3423","103.1","高雄市"
"1502","阿蓮區","12","276","9362","29803","15033","14770","103.1","高雄市"
"1503","路竹區","20","395","16467","52990","27064","25926","103.1","高雄市"
"1504","湖內區","14","260","10155","29220","14988","14232","103.1","高雄市"
"1505","茄萣區","15","339","10375","30863","16011","14852","103.1","高雄市"
"1506","永安區","6","81","5827","14132","7114","7018","103.1","高雄市"
"1507","彌陀區","12","227","6696","19918","10327","9591","103.1","高雄市"
"1508","梓官區","15","286","12359","36398","18819","17579","103.1","高雄市"
"1509","旗山區","21","381","13870","38528","19969","18559","103.1","高雄市"
"1510","美濃區","19","389","14459","41640","21725","19915","103.1","高雄市"
"1511","六龜區","12","221","5696","13921","7526","6395","103.1","高雄市"
"1512","甲仙區","7","103","2375","6438","3429","3009","103.1","高雄市"
"1513","杉林區","7","138","4818","12560","6852","5708","103.1","高雄市"
"1514","內門區","18","207","5076","15318","8342","6976","103.1","高雄市"
"1515","茂林區","3","19","577","1834","925","909","103.1","高雄市"
"1516","桃源區","8","39","1331","4400","2323","2077","103.1","高雄市"
"1517","那瑪夏區","3","20","864","3139","1628","1511","103.1","高雄市"
"1518","高雄市","893","17686","1056921","2779653","1385335","1394318","103.2","高雄市"
"1519","鹽埕區","21","232","10963","25836","12871","12965","103.2","高雄市"
"1520","鼓山區","38","722","54947","135158","65724","69434","103.2","高雄市"
"1521","左營區","40","760","76452","195459","95162","100297","103.2","高雄市"
"1522","楠梓區","37","803","65271","177818","87947","89871","103.2","高雄市"
"1523","三民一","41","659","32987","82932","41152","41780","103.2","高雄市"
"1524","三民二","45","1084","101103","265400","128342","137058","103.2","高雄市"
"1525","新興區","32","456","22729","53087","25617","27470","103.2","高雄市"
"1526","前金區","20","263","12561","27983","13518","14465","103.2","高雄市"
"1527","苓雅區","69","1248","72137","177442","85929","91513","103.2","高雄市"
"1528","前鎮區","59","1298","77595","194602","96219","98383","103.2","高雄市"
"1529","旗津區","13","212","10955","28985","14996","13989","103.2","高雄市"
"1530","小港區","38","697","65567","156188","77938","78250","103.2","高雄市"
"1531","鳳山一","43","1119","69200","179298","87877","91421","103.2","高雄市"
"1532","鳳山二","35","1007","64952","173661","86297","87364","103.2","高雄市"
"1533","林園區","24","525","25258","70486","35920","34566","103.2","高雄市"
"1534","大寮區","25","747","40346","110466","56983","53483","103.2","高雄市"
"1535","大樹區","18","376","13208","43336","22297","21039","103.2","高雄市"
"1536","大社區","9","175","12460","34147","17470","16677","103.2","高雄市"
"1537","仁武區","16","389","29545","79615","40765","38850","103.2","高雄市"
"1538","鳥松區","7","192","17357","43764","22237","21527","103.2","高雄市"
"1539","岡山區","33","540","34246","97837","48740","49097","103.2","高雄市"
"1540","橋頭區","17","359","13074","37021","18884","18137","103.2","高雄市"
"1541","燕巢區","11","288","10251","30522","16218","14304","103.2","高雄市"
"1542","田寮區","10","154","3438","7714","4294","3420","103.2","高雄市"
"1543","阿蓮區","12","276","9362","29747","14995","14752","103.2","高雄市"
"1544","路竹區","20","395","16474","52991","27066","25925","103.2","高雄市"
"1545","湖內區","14","260","10172","29273","15004","14269","103.2","高雄市"
"1546","茄萣區","15","339","10379","30828","16002","14826","103.2","高雄市"
"1547","永安區","6","81","5826","14121","7105","7016","103.2","高雄市"
"1548","彌陀區","12","227","6689","19911","10322","9589","103.2","高雄市"
"1549","梓官區","15","286","12366","36395","18806","17589","103.2","高雄市"
"1550","旗山區","21","381","13870","38511","19959","18552","103.2","高雄市"
"1551","美濃區","19","389","14455","41591","21694","19897","103.2","高雄市"
"1552","六龜區","12","221","5685","13882","7504","6378","103.2","高雄市"
"1553","甲仙區","7","103","2375","6417","3424","2993","103.2","高雄市"
"1554","杉林區","7","138","4818","12546","6845","5701","103.2","高雄市"
"1555","內門區","18","207","5074","15288","8330","6958","103.2","高雄市"
"1556","茂林區","3","19","578","1850","929","921","103.2","高雄市"
"1557","桃源區","8","39","1332","4392","2318","2074","103.2","高雄市"
"1558","那瑪夏區","3","20","864","3153","1635","1518","103.2","高雄市"
"1559","高雄市","893","17686","1057446","2778669","1384641","1394028","103.3","高雄市"
"1560","鹽埕區","21","232","10950","25776","12845","12931","103.3","高雄市"
"1561","鼓山區","38","722","54962","135111","65681","69430","103.3","高雄市"
"1562","左營區","40","760","76480","195404","95093","100311","103.3","高雄市"
"1563","楠梓區","37","803","65359","177903","87949","89954","103.3","高雄市"
"1564","三民一","41","659","33001","82835","41126","41709","103.3","高雄市"
"1565","三民二","45","1084","101128","265282","128283","136999","103.3","高雄市"
"1566","新興區","32","456","22742","53013","25561","27452","103.3","高雄市"
"1567","前金區","20","263","12547","27962","13496","14466","103.3","高雄市"
"1568","苓雅區","69","1248","72103","177206","85821","91385","103.3","高雄市"
"1569","前鎮區","59","1298","77594","194452","96116","98336","103.3","高雄市"
"1570","旗津區","13","212","10947","28958","14992","13966","103.3","高雄市"
"1571","小港區","38","697","65591","156124","77918","78206","103.3","高雄市"
"1572","鳳山一","43","1119","69288","179267","87820","91447","103.3","高雄市"
"1573","鳳山二","35","1007","65056","173809","86350","87459","103.3","高雄市"
"1574","林園區","24","525","25268","70490","35911","34579","103.3","高雄市"
"1575","大寮區","25","747","40384","110501","57002","53499","103.3","高雄市"
"1576","大樹區","18","376","13219","43276","22266","21010","103.3","高雄市"
"1577","大社區","9","175","12483","34186","17461","16725","103.3","高雄市"
"1578","仁武區","16","389","29616","79737","40837","38900","103.3","高雄市"
"1579","鳥松區","7","192","17359","43701","22215","21486","103.3","高雄市"
"1580","岡山區","33","540","34253","97758","48675","49083","103.3","高雄市"
"1581","橋頭區","17","359","13074","37036","18908","18128","103.3","高雄市"
"1582","燕巢區","11","288","10273","30533","16207","14326","103.3","高雄市"
"1583","田寮區","10","154","3439","7705","4289","3416","103.3","高雄市"
"1584","阿蓮區","12","276","9361","29702","14981","14721","103.3","高雄市"
"1585","路竹區","20","395","16474","52974","27056","25918","103.3","高雄市"
"1586","湖內區","14","260","10193","29289","15006","14283","103.3","高雄市"
"1587","茄萣區","15","339","10376","30800","15981","14819","103.3","高雄市"
"1588","永安區","6","81","5821","14097","7102","6995","103.3","高雄市"
"1589","彌陀區","12","227","6693","19921","10319","9602","103.3","高雄市"
"1590","梓官區","15","286","12365","36362","18799","17563","103.3","高雄市"
"1591","旗山區","21","381","13865","38450","19938","18512","103.3","高雄市"
"1592","美濃區","19","389","14451","41570","21687","19883","103.3","高雄市"
"1593","六龜區","12","221","5685","13863","7492","6371","103.3","高雄市"
"1594","甲仙區","7","103","2373","6413","3416","2997","103.3","高雄市"
"1595","杉林區","7","138","4818","12521","6839","5682","103.3","高雄市"
"1596","內門區","18","207","5069","15273","8315","6958","103.3","高雄市"
"1597","茂林區","3","19","579","1853","928","925","103.3","高雄市"
"1598","桃源區","8","39","1342","4385","2314","2071","103.3","高雄市"
"1599","那瑪夏區","3","20","865","3171","1646","1525","103.3","高雄市"
"1600","高雄市","893","17686","1057883","2778132","1384253","1393879","103.4","高雄市"
"1601","鹽埕區","21","232","10937","25734","12830","12904","103.4","高雄市"
"1602","鼓山區","38","722","54993","135111","65662","69449","103.4","高雄市"
"1603","左營區","40","760","76447","195309","95009","100300","103.4","高雄市"
"1604","楠梓區","37","803","65420","177886","87989","89897","103.4","高雄市"
"1605","三民一","41","659","33004","82815","41128","41687","103.4","高雄市"
"1606","三民二","45","1084","101169","265212","128242","136970","103.4","高雄市"
"1607","新興區","32","456","22764","53000","25542","27458","103.4","高雄市"
"1608","前金區","20","263","12550","27965","13495","14470","103.4","高雄市"
"1609","苓雅區","69","1248","72094","177042","85733","91309","103.4","高雄市"
"1610","前鎮區","59","1298","77623","194330","96028","98302","103.4","高雄市"
"1611","旗津區","13","212","10946","28966","15006","13960","103.4","高雄市"
"1612","小港區","38","697","65546","156009","77865","78144","103.4","高雄市"
"1613","鳳山一","43","1119","69368","179334","87839","91495","103.4","高雄市"
"1614","鳳山二","35","1007","65128","173871","86363","87508","103.4","高雄市"
"1615","林園區","24","525","25279","70502","35911","34591","103.4","高雄市"
"1616","大寮區","25","747","40403","110454","56973","53481","103.4","高雄市"
"1617","大樹區","18","376","13232","43221","22230","20991","103.4","高雄市"
"1618","大社區","9","175","12511","34195","17462","16733","103.4","高雄市"
"1619","仁武區","16","389","29652","79880","40905","38975","103.4","高雄市"
"1620","鳥松區","7","192","17365","43716","22219","21497","103.4","高雄市"
"1621","岡山區","33","540","34256","97732","48662","49070","103.4","高雄市"
"1622","橋頭區","17","359","13095","37063","18925","18138","103.4","高雄市"
"1623","燕巢區","11","288","10282","30505","16182","14323","103.4","高雄市"
"1624","田寮區","10","154","3441","7701","4289","3412","103.4","高雄市"
"1625","阿蓮區","12","276","9364","29676","14977","14699","103.4","高雄市"
"1626","路竹區","20","395","16501","52982","27061","25921","103.4","高雄市"
"1627","湖內區","14","260","10203","29291","15005","14286","103.4","高雄市"
"1628","茄萣區","15","339","10374","30778","15958","14820","103.4","高雄市"
"1629","永安區","6","81","5817","14083","7090","6993","103.4","高雄市"
"1630","彌陀區","12","227","6692","19893","10309","9584","103.4","高雄市"
"1631","梓官區","15","286","12367","36387","18811","17576","103.4","高雄市"
"1632","旗山區","21","381","13868","38421","19916","18505","103.4","高雄市"
"1633","美濃區","19","389","14451","41554","21689","19865","103.4","高雄市"
"1634","六龜區","12","221","5680","13877","7493","6384","103.4","高雄市"
"1635","甲仙區","7","103","2379","6406","3413","2993","103.4","高雄市"
"1636","杉林區","7","138","4820","12512","6826","5686","103.4","高雄市"
"1637","內門區","18","207","5070","15273","8309","6964","103.4","高雄市"
"1638","茂林區","3","19","584","1874","936","938","103.4","高雄市"
"1639","桃源區","8","39","1342","4395","2323","2072","103.4","高雄市"
"1640","那瑪夏區","3","20","866","3177","1648","1529","103.4","高雄市"
"1641","高雄市","893","17686","1058800","2777415","1383711","1393704","103.5","高雄市"
"1642","鹽埕區","21","232","10920","25670","12801","12869","103.5","高雄市"
"1643","鼓山區","38","722","55040","135161","65656","69505","103.5","高雄市"
"1644","左營區","40","760","76585","195340","94975","100365","103.5","高雄市"
"1645","楠梓區","37","803","65521","177902","87994","89908","103.5","高雄市"
"1646","三民一","41","659","33003","82711","41078","41633","103.5","高雄市"
"1647","三民二","45","1084","101276","265080","128134","136946","103.5","高雄市"
"1648","新興區","32","456","22752","52908","25489","27419","103.5","高雄市"
"1649","前金區","20","263","12541","27929","13475","14454","103.5","高雄市"
"1650","苓雅區","69","1248","72099","176849","85620","91229","103.5","高雄市"
"1651","前鎮區","59","1298","77708","194295","95978","98317","103.5","高雄市"
"1652","旗津區","13","212","10952","28993","15030","13963","103.5","高雄市"
"1653","小港區","38","697","65556","155953","77838","78115","103.5","高雄市"
"1654","鳳山一","43","1119","69481","179253","87781","91472","103.5","高雄市"
"1655","鳳山二","35","1007","65231","173904","86421","87483","103.5","高雄市"
"1656","林園區","24","525","25288","70481","35888","34593","103.5","高雄市"
"1657","大寮區","25","747","40478","110530","56999","53531","103.5","高雄市"
"1658","大樹區","18","376","13229","43205","22230","20975","103.5","高雄市"
"1659","大社區","9","175","12513","34181","17459","16722","103.5","高雄市"
"1660","仁武區","16","389","29741","80017","40958","39059","103.5","高雄市"
"1661","鳥松區","7","192","17377","43665","22200","21465","103.5","高雄市"
"1662","岡山區","33","540","34272","97700","48649","49051","103.5","高雄市"
"1663","橋頭區","17","359","13096","37070","18920","18150","103.5","高雄市"
"1664","燕巢區","11","288","10289","30497","16177","14320","103.5","高雄市"
"1665","田寮區","10","154","3438","7693","4284","3409","103.5","高雄市"
"1666","阿蓮區","12","276","9355","29654","14964","14690","103.5","高雄市"
"1667","路竹區","20","395","16514","52980","27060","25920","103.5","高雄市"
"1668","湖內區","14","260","10244","29322","15015","14307","103.5","高雄市"
"1669","茄萣區","15","339","10365","30736","15930","14806","103.5","高雄市"
"1670","永安區","6","81","5816","14086","7083","7003","103.5","高雄市"
"1671","彌陀區","12","227","6692","19909","10318","9591","103.5","高雄市"
"1672","梓官區","15","286","12381","36346","18790","17556","103.5","高雄市"
"1673","旗山區","21","381","13874","38396","19915","18481","103.5","高雄市"
"1674","美濃區","19","389","14455","41499","21673","19826","103.5","高雄市"
"1675","六龜區","12","221","5669","13837","7468","6369","103.5","高雄市"
"1676","甲仙區","7","103","2374","6411","3413","2998","103.5","高雄市"
"1677","杉林區","7","138","4815","12531","6831","5700","103.5","高雄市"
"1678","內門區","18","207","5068","15264","8303","6961","103.5","高雄市"
"1679","茂林區","3","19","584","1874","934","940","103.5","高雄市"
"1680","桃源區","8","39","1342","4388","2321","2067","103.5","高雄市"
"1681","那瑪夏區","3","20","866","3195","1659","1536","103.5","高雄市"
"1682","高雄市","893","17686","1059475","2777296","1383480","1393816","103.6","高雄市"
"1683","鹽埕區","21","232","10906","25590","12772","12818","103.6","高雄市"
"1684","鼓山區","38","722","55110","135207","65672","69535","103.6","高雄市"
"1685","左營區","40","760","76647","195397","94939","100458","103.6","高雄市"
"1686","楠梓區","37","803","65606","177984","88022","89962","103.6","高雄市"
"1687","三民一","41","659","33011","82684","41047","41637","103.6","高雄市"
"1688","三民二","45","1084","101347","265161","128195","136966","103.6","高雄市"
"1689","新興區","32","456","22742","52787","25440","27347","103.6","高雄市"
"1690","前金區","20","263","12534","27908","13437","14471","103.6","高雄市"
"1691","苓雅區","69","1248","72084","176654","85545","91109","103.6","高雄市"
"1692","前鎮區","59","1298","77733","194197","95937","98260","103.6","高雄市"
"1693","旗津區","13","212","10927","28973","15023","13950","103.6","高雄市"
"1694","小港區","38","697","65581","155948","77823","78125","103.6","高雄市"
"1695","鳳山一","43","1119","69499","179190","87772","91418","103.6","高雄市"
"1696","鳳山二","35","1007","65300","173952","86415","87537","103.6","高雄市"
"1697","林園區","24","525","25315","70504","35894","34610","103.6","高雄市"
"1698","大寮區","25","747","40527","110600","57024","53576","103.6","高雄市"
"1699","大樹區","18","376","13226","43203","22230","20973","103.6","高雄市"
"1700","大社區","9","175","12534","34199","17455","16744","103.6","高雄市"
"1701","仁武區","16","389","29850","80170","41023","39147","103.6","高雄市"
"1702","鳥松區","7","192","17397","43667","22193","21474","103.6","高雄市"
"1703","岡山區","33","540","34298","97734","48652","49082","103.6","高雄市"
"1704","橋頭區","17","359","13102","37087","18931","18156","103.6","高雄市"
"1705","燕巢區","11","288","10315","30487","16175","14312","103.6","高雄市"
"1706","田寮區","10","154","3434","7692","4279","3413","103.6","高雄市"
"1707","阿蓮區","12","276","9352","29617","14945","14672","103.6","高雄市"
"1708","路竹區","20","395","16521","52961","27056","25905","103.6","高雄市"
"1709","湖內區","14","260","10265","29321","15017","14304","103.6","高雄市"
"1710","茄萣區","15","339","10364","30732","15919","14813","103.6","高雄市"
"1711","永安區","6","81","5814","14108","7089","7019","103.6","高雄市"
"1712","彌陀區","12","227","6701","19925","10315","9610","103.6","高雄市"
"1713","梓官區","15","286","12397","36367","18795","17572","103.6","高雄市"
"1714","旗山區","21","381","13869","38341","19885","18456","103.6","高雄市"
"1715","美濃區","19","389","14470","41481","21672","19809","103.6","高雄市"
"1716","六龜區","12","221","5659","13802","7443","6359","103.6","高雄市"
"1717","甲仙區","7","103","2372","6405","3414","2991","103.6","高雄市"
"1718","杉林區","7","138","4824","12595","6857","5738","103.6","高雄市"
"1719","內門區","18","207","5067","15254","8291","6963","103.6","高雄市"
"1720","茂林區","3","19","584","1876","931","945","103.6","高雄市"
"1721","桃源區","8","39","1326","4340","2291","2049","103.6","高雄市"
"1722","那瑪夏區","3","20","865","3196","1665","1531","103.6","高雄市"
"1723","高雄市","891","17624","1060315","2777240","1383208","1394032","103.7","高雄市"
"1724","鹽埕區","21","232","10910","25571","12770","12801","103.7","高雄市"
"1725","鼓山區","38","722","55161","135288","65724","69564","103.7","高雄市"
"1726","左營區","39","760","76715","195351","94867","100484","103.7","高雄市"
"1727","楠梓區","37","803","65677","178129","88049","90080","103.7","高雄市"
"1728","三民一","41","659","33030","82626","40973","41653","103.7","高雄市"
"1729","三民二","45","1084","101411","264980","128074","136906","103.7","高雄市"
"1730","新興區","32","456","22731","52745","25428","27317","103.7","高雄市"
"1731","前金區","20","263","12516","27884","13424","14460","103.7","高雄市"
"1732","苓雅區","69","1248","72076","176368","85381","90987","103.7","高雄市"
"1733","前鎮區","59","1298","77806","194144","95941","98203","103.7","高雄市"
"1734","旗津區","13","212","10926","28978","15023","13955","103.7","高雄市"
"1735","小港區","38","697","65644","155879","77783","78096","103.7","高雄市"
"1736","鳳山一","41","1052","69531","179156","87736","91420","103.7","高雄市"
"1737","鳳山二","35","1007","65355","174138","86481","87657","103.7","高雄市"
"1738","林園區","24","525","25335","70508","35891","34617","103.7","高雄市"
"1739","大寮區","25","747","40615","110779","57109","53670","103.7","高雄市"
"1740","大樹區","18","376","13236","43198","22211","20987","103.7","高雄市"
"1741","大社區","9","175","12568","34251","17468","16783","103.7","高雄市"
"1742","仁武區","16","389","29944","80330","41113","39217","103.7","高雄市"
"1743","鳥松區","7","192","17417","43611","22165","21446","103.7","高雄市"
"1744","岡山區","33","540","34328","97741","48649","49092","103.7","高雄市"
"1745","橋頭區","17","359","13117","37081","18923","18158","103.7","高雄市"
"1746","燕巢區","11","288","10333","30484","16180","14304","103.7","高雄市"
"1747","田寮區","10","154","3430","7697","4285","3412","103.7","高雄市"
"1748","阿蓮區","12","276","9362","29606","14935","14671","103.7","高雄市"
"1749","路竹區","20","395","16552","53004","27079","25925","103.7","高雄市"
"1750","湖內區","14","260","10269","29337","15031","14306","103.7","高雄市"
"1751","茄萣區","15","339","10370","30721","15904","14817","103.7","高雄市"
"1752","永安區","6","81","5816","14127","7103","7024","103.7","高雄市"
"1753","彌陀區","12","227","6705","19925","10304","9621","103.7","高雄市"
"1754","梓官區","15","286","12403","36357","18785","17572","103.7","高雄市"
"1755","旗山區","21","381","13877","38304","19867","18437","103.7","高雄市"
"1756","美濃區","19","389","14461","41445","21666","19779","103.7","高雄市"
"1757","六龜區","12","221","5666","13783","7437","6346","103.7","高雄市"
"1758","甲仙區","7","103","2371","6427","3416","3011","103.7","高雄市"
"1759","杉林區","8","143","4827","12605","6863","5742","103.7","高雄市"
"1760","內門區","18","207","5063","15256","8281","6975","103.7","高雄市"
"1761","茂林區","3","19","584","1894","939","955","103.7","高雄市"
"1762","桃源區","8","39","1314","4317","2276","2041","103.7","高雄市"
"1763","那瑪夏區","3","20","863","3215","1674","1541","103.7","高雄市"
"1764","高雄市","891","17624","1061818","2777318","1382884","1394434","103.8","高雄市"
"1765","鹽埕區","21","232","10910","25548","12740","12808","103.8","高雄市"
"1766","鼓山區","38","722","55294","135382","65766","69616","103.8","高雄市"
"1767","左營區","39","760","76855","195467","94870","100597","103.8","高雄市"
"1768","楠梓區","37","803","65826","178164","88036","90128","103.8","高雄市"
"1769","三民一","41","659","33061","82528","40924","41604","103.8","高雄市"
"1770","三民二","45","1084","101606","265043","128072","136971","103.8","高雄市"
"1771","新興區","32","456","22748","52654","25367","27287","103.8","高雄市"
"1772","前金區","20","263","12531","27855","13407","14448","103.8","高雄市"
"1773","苓雅區","69","1248","72160","176244","85267","90977","103.8","高雄市"
"1774","前鎮區","59","1298","77866","194042","95869","98173","103.8","高雄市"
"1775","旗津區","13","212","10936","28973","15014","13959","103.8","高雄市"
"1776","小港區","38","697","65749","155948","77819","78129","103.8","高雄市"
"1777","鳳山一","41","1052","69589","179091","87682","91409","103.8","高雄市"
"1778","鳳山二","35","1007","65459","174250","86529","87721","103.8","高雄市"
"1779","林園區","24","525","25360","70480","35869","34611","103.8","高雄市"
"1780","大寮區","25","747","40726","110950","57191","53759","103.8","高雄市"
"1781","大樹區","18","376","13251","43223","22212","21011","103.8","高雄市"
"1782","大社區","9","175","12592","34299","17503","16796","103.8","高雄市"
"1783","仁武區","16","389","30030","80442","41164","39278","103.8","高雄市"
"1784","鳥松區","7","192","17428","43602","22152","21450","103.8","高雄市"
"1785","岡山區","33","540","34355","97693","48618","49075","103.8","高雄市"
"1786","橋頭區","17","359","13164","37150","18949","18201","103.8","高雄市"
"1787","燕巢區","11","288","10331","30451","16149","14302","103.8","高雄市"
"1788","田寮區","10","154","3428","7699","4282","3417","103.8","高雄市"
"1789","阿蓮區","12","276","9361","29597","14935","14662","103.8","高雄市"
"1790","路竹區","20","395","16569","52971","27064","25907","103.8","高雄市"
"1791","湖內區","14","260","10293","29356","15025","14331","103.8","高雄市"
"1792","茄萣區","15","339","10374","30722","15904","14818","103.8","高雄市"
"1793","永安區","6","81","5822","14141","7112","7029","103.8","高雄市"
"1794","彌陀區","12","227","6709","19907","10297","9610","103.8","高雄市"
"1795","梓官區","15","286","12417","36395","18802","17593","103.8","高雄市"
"1796","旗山區","21","381","13872","38246","19836","18410","103.8","高雄市"
"1797","美濃區","19","389","14456","41372","21619","19753","103.8","高雄市"
"1798","六龜區","12","221","5659","13751","7419","6332","103.8","高雄市"
"1799","甲仙區","7","103","2371","6426","3413","3013","103.8","高雄市"
"1800","杉林區","8","143","4841","12617","6865","5752","103.8","高雄市"
"1801","內門區","18","207","5064","15236","8264","6972","103.8","高雄市"
"1802","茂林區","3","19","584","1899","942","957","103.8","高雄市"
"1803","桃源區","8","39","1309","4289","2260","2029","103.8","高雄市"
"1804","那瑪夏區","3","20","862","3215","1676","1539","103.8","高雄市"
"1805","高雄市","891","17624","1063794","2777461","1382862","1394599","103.9","高雄市"
"1806","鹽埕區","21","232","10904","25479","12704","12775","103.9","高雄市"
"1807","鼓山區","38","722","55478","135524","65837","69687","103.9","高雄市"
"1808","左營區","39","760","77050","195536","94850","100686","103.9","高雄市"
"1809","楠梓區","37","803","66028","178320","88122","90198","103.9","高雄市"
"1810","三民一","41","659","33127","82496","40926","41570","103.9","高雄市"
"1811","三民二","45","1084","101739","264955","127966","136989","103.9","高雄市"
"1812","新興區","32","456","22791","52624","25338","27286","103.9","高雄市"
"1813","前金區","20","263","12571","27869","13421","14448","103.9","高雄市"
"1814","苓雅區","69","1248","72226","176033","85171","90862","103.9","高雄市"
"1815","前鎮區","59","1298","78019","194080","95913","98167","103.9","高雄市"
"1816","旗津區","13","212","10942","28960","15014","13946","103.9","高雄市"
"1817","小港區","38","697","65846","155893","77752","78141","103.9","高雄市"
"1818","鳳山一","41","1052","69663","179055","87685","91370","103.9","高雄市"
"1819","鳳山二","35","1007","65640","174421","86590","87831","103.9","高雄市"
"1820","林園區","24","525","25380","70455","35853","34602","103.9","高雄市"
"1821","大寮區","25","747","40830","111054","57225","53829","103.9","高雄市"
"1822","大樹區","18","376","13269","43224","22219","21005","103.9","高雄市"
"1823","大社區","9","175","12613","34333","17516","16817","103.9","高雄市"
"1824","仁武區","16","389","30160","80610","41237","39373","103.9","高雄市"
"1825","鳥松區","7","192","17469","43647","22189","21458","103.9","高雄市"
"1826","岡山區","33","540","34403","97662","48606","49056","103.9","高雄市"
"1827","橋頭區","17","359","13187","37135","18940","18195","103.9","高雄市"
"1828","燕巢區","11","288","10342","30443","16145","14298","103.9","高雄市"
"1829","田寮區","10","154","3422","7701","4279","3422","103.9","高雄市"
"1830","阿蓮區","12","276","9366","29560","14922","14638","103.9","高雄市"
"1831","路竹區","20","395","16628","52989","27083","25906","103.9","高雄市"
"1832","湖內區","14","260","10318","29378","15041","14337","103.9","高雄市"
"1833","茄萣區","15","339","10380","30681","15888","14793","103.9","高雄市"
"1834","永安區","6","81","5822","14149","7110","7039","103.9","高雄市"
"1835","彌陀區","12","227","6722","19917","10305","9612","103.9","高雄市"
"1836","梓官區","15","286","12418","36368","18787","17581","103.9","高雄市"
"1837","旗山區","21","381","13877","38183","19802","18381","103.9","高雄市"
"1838","美濃區","19","389","14469","41333","21614","19719","103.9","高雄市"
"1839","六龜區","12","221","5663","13734","7417","6317","103.9","高雄市"
"1840","甲仙區","7","103","2372","6426","3413","3013","103.9","高雄市"
"1841","杉林區","8","143","4841","12614","6864","5750","103.9","高雄市"
"1842","內門區","18","207","5060","15215","8244","6971","103.9","高雄市"
"1843","茂林區","3","19","584","1906","947","959","103.9","高雄市"
"1844","桃源區","8","39","1314","4289","2256","2033","103.9","高雄市"
"1845","那瑪夏區","3","20","861","3210","1671","1539","103.9","高雄市"
"1846","高雄市","891","17624","1063871","2777773","1382805","1394968","103.10","高雄市"
"1847","鹽埕區","21","232","10892","25454","12699","12755","103.10","高雄市"
"1848","鼓山區","38","722","55452","135563","65825","69738","103.10","高雄市"
"1849","左營區","39","760","77058","195529","94859","100670","103.10","高雄市"
"1850","楠梓區","37","803","66034","178356","88114","90242","103.10","高雄市"
"1851","三民一","41","659","33110","82438","40903","41535","103.10","高雄市"
"1852","三民二","45","1084","101750","265026","127970","137056","103.10","高雄市"
"1853","新興區","32","456","22784","52614","25322","27292","103.10","高雄市"
"1854","前金區","20","263","12557","27825","13398","14427","103.10","高雄市"
"1855","苓雅區","69","1248","72205","175977","85116","90861","103.10","高雄市"
"1856","前鎮區","59","1298","78022","193989","95867","98122","103.10","高雄市"
"1857","旗津區","13","212","10946","28967","15029","13938","103.10","高雄市"
"1858","小港區","38","697","65893","156037","77812","78225","103.10","高雄市"
"1859","鳳山一","41","1052","69633","179031","87674","91357","103.10","高雄市"
"1860","鳳山二","35","1007","65665","174555","86610","87945","103.10","高雄市"
"1861","林園區","24","525","25375","70426","35850","34576","103.10","高雄市"
"1862","大寮區","25","747","40841","111073","57214","53859","103.10","高雄市"
"1863","大樹區","18","376","13276","43206","22215","20991","103.10","高雄市"
"1864","大社區","9","175","12629","34372","17535","16837","103.10","高雄市"
"1865","仁武區","16","389","30202","80715","41274","39441","103.10","高雄市"
"1866","鳥松區","7","192","17482","43671","22197","21474","103.10","高雄市"
"1867","岡山區","33","540","34414","97710","48616","49094","103.10","高雄市"
"1868","橋頭區","17","359","13185","37158","18951","18207","103.10","高雄市"
"1869","燕巢區","11","288","10340","30421","16129","14292","103.10","高雄市"
"1870","田寮區","10","154","3416","7697","4270","3427","103.10","高雄市"
"1871","阿蓮區","12","276","9378","29549","14923","14626","103.10","高雄市"
"1872","路竹區","20","395","16643","53000","27087","25913","103.10","高雄市"
"1873","湖內區","14","260","10320","29387","15052","14335","103.10","高雄市"
"1874","茄萣區","15","339","10377","30682","15889","14793","103.10","高雄市"
"1875","永安區","6","81","5821","14161","7117","7044","103.10","高雄市"
"1876","彌陀區","12","227","6714","19911","10291","9620","103.10","高雄市"
"1877","梓官區","15","286","12419","36374","18796","17578","103.10","高雄市"
"1878","旗山區","21","381","13875","38166","19793","18373","103.10","高雄市"
"1879","美濃區","19","389","14476","41358","21620","19738","103.10","高雄市"
"1880","六龜區","12","221","5659","13733","7417","6316","103.10","高雄市"
"1881","甲仙區","7","103","2372","6423","3410","3013","103.10","高雄市"
"1882","杉林區","8","143","4842","12600","6854","5746","103.10","高雄市"
"1883","內門區","18","207","5059","15215","8237","6978","103.10","高雄市"
"1884","茂林區","3","19","583","1909","947","962","103.10","高雄市"
"1885","桃源區","8","39","1312","4290","2258","2032","103.10","高雄市"
"1886","那瑪夏區","3","20","860","3205","1665","1540","103.10","高雄市"
"1887","高雄市","891","17624","1063946","2778155","1382820","1395335","103.11","高雄市"
"1888","鹽埕區","21","232","10885","25450","12692","12758","103.11","高雄市"
"1889","鼓山區","38","722","55446","135592","65840","69752","103.11","高雄市"
"1890","左營區","39","760","77044","195554","94873","100681","103.11","高雄市"
"1891","楠梓區","37","803","66065","178448","88159","90289","103.11","高雄市"
"1892","三民一","41","659","33092","82410","40886","41524","103.11","高雄市"
"1893","三民二","45","1084","101758","265067","127972","137095","103.11","高雄市"
"1894","新興區","32","456","22774","52613","25320","27293","103.11","高雄市"
"1895","前金區","20","263","12551","27817","13396","14421","103.11","高雄市"
"1896","苓雅區","69","1248","72196","175963","85118","90845","103.11","高雄市"
"1897","前鎮區","59","1298","78036","193933","95801","98132","103.11","高雄市"
"1898","旗津區","13","212","10944","28957","15018","13939","103.11","高雄市"
"1899","小港區","38","697","65905","156075","77839","78236","103.11","高雄市"
"1900","鳳山一","41","1052","69623","179125","87670","91455","103.11","高雄市"
"1901","鳳山二","35","1007","65678","174665","86670","87995","103.11","高雄市"
"1902","林園區","24","525","25391","70478","35870","34608","103.11","高雄市"
"1903","大寮區","25","747","40834","111059","57211","53848","103.11","高雄市"
"1904","大樹區","18","376","13278","43210","22215","20995","103.11","高雄市"
"1905","大社區","9","175","12648","34399","17554","16845","103.11","高雄市"
"1906","仁武區","16","389","30249","80773","41285","39488","103.11","高雄市"
"1907","鳥松區","7","192","17486","43711","22206","21505","103.11","高雄市"
"1908","岡山區","33","540","34414","97730","48637","49093","103.11","高雄市"
"1909","橋頭區","17","359","13185","37173","18951","18222","103.11","高雄市"
"1910","燕巢區","11","288","10337","30392","16106","14286","103.11","高雄市"
"1911","田寮區","10","154","3412","7694","4263","3431","103.11","高雄市"
"1912","阿蓮區","12","276","9384","29558","14923","14635","103.11","高雄市"
"1913","路竹區","20","395","16661","53020","27101","25919","103.11","高雄市"
"1914","湖內區","14","260","10319","29382","15046","14336","103.11","高雄市"
"1915","茄萣區","15","339","10379","30672","15878","14794","103.11","高雄市"
"1916","永安區","6","81","5816","14149","7108","7041","103.11","高雄市"
"1917","彌陀區","12","227","6716","19906","10289","9617","103.11","高雄市"
"1918","梓官區","15","286","12421","36378","18782","17596","103.11","高雄市"
"1919","旗山區","21","381","13864","38143","19776","18367","103.11","高雄市"
"1920","美濃區","19","389","14470","41325","21609","19716","103.11","高雄市"
"1921","六龜區","12","221","5659","13702","7402","6300","103.11","高雄市"
"1922","甲仙區","7","103","2370","6436","3409","3027","103.11","高雄市"
"1923","杉林區","8","143","4838","12579","6840","5739","103.11","高雄市"
"1924","內門區","18","207","5058","15204","8233","6971","103.11","高雄市"
"1925","茂林區","3","19","584","1913","949","964","103.11","高雄市"
"1926","桃源區","8","39","1315","4298","2261","2037","103.11","高雄市"
"1927","那瑪夏區","3","20","861","3202","1662","1540","103.11","高雄市"
"1928","高雄市","891","17624","1064667","2778992","1382998","1395994","103.12","高雄市"
"1929","鹽埕區","21","232","10894","25400","12663","12737","103.12","高雄市"
"1930","鼓山區","38","722","55501","135667","65877","69790","103.12","高雄市"
"1931","左營區","39","760","77053","195643","94873","100770","103.12","高雄市"
"1932","楠梓區","37","803","66137","178532","88198","90334","103.12","高雄市"
"1933","三民一","41","659","33070","82323","40819","41504","103.12","高雄市"
"1934","三民二","45","1084","101815","265296","128040","137256","103.12","高雄市"
"1935","新興區","32","456","22730","52534","25292","27242","103.12","高雄市"
"1936","前金區","20","263","12557","27832","13392","14440","103.12","高雄市"
"1937","苓雅區","69","1248","72170","175854","85047","90807","103.12","高雄市"
"1938","前鎮區","59","1298","78093","193952","95757","98195","103.12","高雄市"
"1939","旗津區","13","212","10954","28958","15010","13948","103.12","高雄市"
"1940","小港區","38","697","66012","156171","77893","78278","103.12","高雄市"
"1941","鳳山一","41","1052","69643","179129","87695","91434","103.12","高雄市"
"1942","鳳山二","35","1007","65797","174964","86804","88160","103.12","高雄市"
"1943","林園區","24","525","25394","70476","35853","34623","103.12","高雄市"
"1944","大寮區","25","747","40902","111191","57243","53948","103.12","高雄市"
"1945","大樹區","18","376","13296","43190","22200","20990","103.12","高雄市"
"1946","大社區","9","175","12658","34455","17566","16889","103.12","高雄市"
"1947","仁武區","16","389","30353","80994","41381","39613","103.12","高雄市"
"1948","鳥松區","7","192","17499","43735","22235","21500","103.12","高雄市"
"1949","岡山區","33","540","34443","97751","48636","49115","103.12","高雄市"
"1950","橋頭區","17","359","13185","37198","18957","18241","103.12","高雄市"
"1951","燕巢區","11","288","10340","30397","16116","14281","103.12","高雄市"
"1952","田寮區","10","154","3405","7680","4254","3426","103.12","高雄市"
"1953","阿蓮區","12","276","9386","29566","14921","14645","103.12","高雄市"
"1954","路竹區","20","395","16686","53064","27123","25941","103.12","高雄市"
"1955","湖內區","14","260","10346","29399","15050","14349","103.12","高雄市"
"1956","茄萣區","15","339","10404","30690","15882","14808","103.12","高雄市"
"1957","永安區","6","81","5806","14148","7107","7041","103.12","高雄市"
"1958","彌陀區","12","227","6701","19854","10274","9580","103.12","高雄市"
"1959","梓官區","15","286","12429","36384","18782","17602","103.12","高雄市"
"1960","旗山區","21","381","13856","38100","19770","18330","103.12","高雄市"
"1961","美濃區","19","389","14480","41258","21586","19672","103.12","高雄市"
"1962","六龜區","12","221","5646","13663","7384","6279","103.12","高雄市"
"1963","甲仙區","7","103","2372","6420","3401","3019","103.12","高雄市"
"1964","杉林區","8","143","4831","12531","6821","5710","103.12","高雄市"
"1965","內門區","18","207","5063","15178","8224","6954","103.12","高雄市"
"1966","茂林區","3","19","584","1915","948","967","103.12","高雄市"
"1967","桃源區","8","39","1315","4296","2262","2034","103.12","高雄市"
"1968","那瑪夏區","3","20","861","3204","1662","1542","103.12","高雄市"
"1969","高雄市","891","17624","1065667","2779355","1383118","1396237","104.1","高雄市"
"1970","鹽埕區","21","232","10887","25411","12674","12737","104.1","高雄市"
"1971","鼓山區","38","722","55541","135759","65934","69825","104.1","高雄市"
"1972","左營區","39","760","77136","195777","94928","100849","104.1","高雄市"
"1973","楠梓區","37","803","66223","178666","88237","90429","104.1","高雄市"
"1974","三民一","41","659","33074","82241","40784","41457","104.1","高雄市"
"1975","三民二","45","1084","101884","265370","128064","137306","104.1","高雄市"
"1976","新興區","32","456","22726","52540","25290","27250","104.1","高雄市"
"1977","前金區","20","263","12546","27733","13346","14387","104.1","高雄市"
"1978","苓雅區","69","1248","72201","175762","84957","90805","104.1","高雄市"
"1979","前鎮區","59","1298","78125","193842","95698","98144","104.1","高雄市"
"1980","旗津區","13","212","10955","28907","14986","13921","104.1","高雄市"
"1981","小港區","38","697","66080","156205","77922","78283","104.1","高雄市"
"1982","鳳山一","41","1052","69766","179311","87754","91557","104.1","高雄市"
"1983","鳳山二","35","1007","65903","175101","86873","88228","104.1","高雄市"
"1984","林園區","24","525","25419","70485","35843","34642","104.1","高雄市"
"1985","大寮區","25","747","40940","111231","57256","53975","104.1","高雄市"
"1986","大樹區","18","376","13313","43237","22213","21024","104.1","高雄市"
"1987","大社區","9","175","12665","34449","17557","16892","104.1","高雄市"
"1988","仁武區","16","389","30409","81088","41444","39644","104.1","高雄市"
"1989","鳥松區","7","192","17539","43809","22293","21516","104.1","高雄市"
"1990","岡山區","33","540","34467","97787","48653","49134","104.1","高雄市"
"1991","橋頭區","17","359","13198","37227","18976","18251","104.1","高雄市"
"1992","燕巢區","11","288","10338","30364","16113","14251","104.1","高雄市"
"1993","田寮區","10","154","3399","7643","4235","3408","104.1","高雄市"
"1994","阿蓮區","12","276","9395","29555","14909","14646","104.1","高雄市"
"1995","路竹區","20","395","16699","53071","27140","25931","104.1","高雄市"
"1996","湖內區","14","260","10385","29418","15070","14348","104.1","高雄市"
"1997","茄萣區","15","339","10441","30649","15854","14795","104.1","高雄市"
"1998","永安區","6","81","5805","14111","7087","7024","104.1","高雄市"
"1999","彌陀區","12","227","6714","19827","10260","9567","104.1","高雄市"
"2000","梓官區","15","286","12449","36406","18805","17601","104.1","高雄市"
"2001","旗山區","21","381","13847","38079","19766","18313","104.1","高雄市"
"2002","美濃區","19","389","14502","41167","21537","19630","104.1","高雄市"
"2003","六龜區","12","221","5653","13652","7382","6270","104.1","高雄市"
"2004","甲仙區","7","103","2380","6415","3399","3016","104.1","高雄市"
"2005","杉林區","8","143","4832","12520","6814","5706","104.1","高雄市"
"2006","內門區","18","207","5066","15158","8214","6944","104.1","高雄市"
"2007","茂林區","3","19","584","1910","943","967","104.1","高雄市"
"2008","桃源區","8","39","1317","4278","2255","2023","104.1","高雄市"
"2009","那瑪夏區","3","20","864","3194","1653","1541","104.1","高雄市"
"2010","高雄市","891","17624","1066150","2779527","1383011","1396516","104.2","高雄市"
"2011","鹽埕區","21","232","10888","25379","12649","12730","104.2","高雄市"
"2012","鼓山區","38","722","55594","135910","65986","69924","104.2","高雄市"
"2013","左營區","39","760","77172","195820","94907","100913","104.2","高雄市"
"2014","楠梓區","37","803","66285","178746","88293","90453","104.2","高雄市"
"2015","三民一","41","659","33068","82189","40768","41421","104.2","高雄市"
"2016","三民二","45","1084","101885","265339","128015","137324","104.2","高雄市"
"2017","新興區","32","456","22728","52517","25280","27237","104.2","高雄市"
"2018","前金區","20","263","12553","27728","13352","14376","104.2","高雄市"
"2019","苓雅區","69","1248","72163","175691","84899","90792","104.2","高雄市"
"2020","前鎮區","59","1298","78147","193717","95626","98091","104.2","高雄市"
"2021","旗津區","13","212","10977","28929","14996","13933","104.2","高雄市"
"2022","小港區","38","697","66084","156177","77901","78276","104.2","高雄市"
"2023","鳳山一","41","1052","69810","179386","87788","91598","104.2","高雄市"
"2024","鳳山二","35","1007","66004","175322","86981","88341","104.2","高雄市"
"2025","林園區","24","525","25426","70477","35819","34658","104.2","高雄市"
"2026","大寮區","25","747","40949","111269","57265","54004","104.2","高雄市"
"2027","大樹區","18","376","13324","43246","22217","21029","104.2","高雄市"
"2028","大社區","9","175","12665","34452","17544","16908","104.2","高雄市"
"2029","仁武區","16","389","30433","81163","41461","39702","104.2","高雄市"
"2030","鳥松區","7","192","17539","43800","22298","21502","104.2","高雄市"
"2031","岡山區","33","540","34473","97808","48663","49145","104.2","高雄市"
"2032","橋頭區","17","359","13204","37231","18983","18248","104.2","高雄市"
"2033","燕巢區","11","288","10344","30366","16110","14256","104.2","高雄市"
"2034","田寮區","10","154","3402","7617","4222","3395","104.2","高雄市"
"2035","阿蓮區","12","276","9388","29534","14898","14636","104.2","高雄市"
"2036","路竹區","20","395","16714","53062","27133","25929","104.2","高雄市"
"2037","湖內區","14","260","10397","29428","15075","14353","104.2","高雄市"
"2038","茄萣區","15","339","10444","30627","15844","14783","104.2","高雄市"
"2039","永安區","6","81","5800","14108","7087","7021","104.2","高雄市"
"2040","彌陀區","12","227","6740","19804","10246","9558","104.2","高雄市"
"2041","梓官區","15","286","12495","36459","18826","17633","104.2","高雄市"
"2042","旗山區","21","381","13844","38047","19753","18294","104.2","高雄市"
"2043","美濃區","19","389","14519","41120","21509","19611","104.2","高雄市"
"2044","六龜區","12","221","5652","13656","7376","6280","104.2","高雄市"
"2045","甲仙區","7","103","2373","6401","3392","3009","104.2","高雄市"
"2046","杉林區","8","143","4834","12509","6811","5698","104.2","高雄市"
"2047","內門區","18","207","5064","15133","8196","6937","104.2","高雄市"
"2048","茂林區","3","19","584","1900","938","962","104.2","高雄市"
"2049","桃源區","8","39","1320","4276","2254","2022","104.2","高雄市"
"2050","那瑪夏區","3","20","865","3184","1650","1534","104.2","高雄市"
"2051","高雄市","891","17624","1066924","2779136","1382597","1396539","104.3","高雄市"
"2052","鹽埕區","21","232","10874","25363","12636","12727","104.3","高雄市"
"2053","鼓山區","38","722","55659","136048","66062","69986","104.3","高雄市"
"2054","左營區","39","760","77242","195932","94953","100979","104.3","高雄市"
"2055","楠梓區","37","803","66391","178785","88271","90514","104.3","高雄市"
"2056","三民一","41","659","33078","82112","40714","41398","104.3","高雄市"
"2057","三民二","45","1084","101965","265442","128056","137386","104.3","高雄市"
"2058","新興區","32","456","22740","52446","25249","27197","104.3","高雄市"
"2059","前金區","20","263","12539","27651","13300","14351","104.3","高雄市"
"2060","苓雅區","69","1248","72151","175464","84785","90679","104.3","高雄市"
"2061","前鎮區","59","1298","78194","193601","95540","98061","104.3","高雄市"
"2062","旗津區","13","212","10991","28887","14987","13900","104.3","高雄市"
"2063","小港區","38","697","66094","156086","77848","78238","104.3","高雄市"
"2064","鳳山一","41","1052","69894","179475","87783","91692","104.3","高雄市"
"2065","鳳山二","35","1007","66110","175501","87069","88432","104.3","高雄市"
"2066","林園區","24","525","25428","70451","35795","34656","104.3","高雄市"
"2067","大寮區","25","747","41011","111332","57273","54059","104.3","高雄市"
"2068","大樹區","18","376","13331","43222","22216","21006","104.3","高雄市"
"2069","大社區","9","175","12664","34448","17541","16907","104.3","高雄市"
"2070","仁武區","16","389","30498","81194","41460","39734","104.3","高雄市"
"2071","鳥松區","7","192","17527","43748","22271","21477","104.3","高雄市"
"2072","岡山區","33","540","34477","97794","48648","49146","104.3","高雄市"
"2073","橋頭區","17","359","13217","37299","19013","18286","104.3","高雄市"
"2074","燕巢區","11","288","10338","30313","16082","14231","104.3","高雄市"
"2075","田寮區","10","154","3403","7613","4215","3398","104.3","高雄市"
"2076","阿蓮區","12","276","9387","29508","14883","14625","104.3","高雄市"
"2077","路竹區","20","395","16750","53028","27123","25905","104.3","高雄市"
"2078","湖內區","14","260","10419","29454","15068","14386","104.3","高雄市"
"2079","茄萣區","15","339","10445","30591","15834","14757","104.3","高雄市"
"2080","永安區","6","81","5796","14084","7071","7013","104.3","高雄市"
"2081","彌陀區","12","227","6753","19786","10235","9551","104.3","高雄市"
"2082","梓官區","15","286","12499","36424","18827","17597","104.3","高雄市"
"2083","旗山區","21","381","13841","38002","19718","18284","104.3","高雄市"
"2084","美濃區","19","389","14544","41101","21503","19598","104.3","高雄市"
"2085","六龜區","12","221","5645","13628","7361","6267","104.3","高雄市"
"2086","甲仙區","7","103","2373","6370","3383","2987","104.3","高雄市"
"2087","杉林區","8","143","4826","12493","6806","5687","104.3","高雄市"
"2088","內門區","18","207","5063","15123","8190","6933","104.3","高雄市"
"2089","茂林區","3","19","580","1888","934","954","104.3","高雄市"
"2090","桃源區","8","39","1323","4277","2252","2025","104.3","高雄市"
"2091","那瑪夏區","3","20","864","3172","1642","1530","104.3","高雄市"
"2092","高雄市","891","17624","1067459","2778914","1382344","1396570","104.4","高雄市"
"2093","鹽埕區","21","232","10855","25307","12616","12691","104.4","高雄市"
"2094","鼓山區","38","722","55675","136017","66061","69956","104.4","高雄市"
"2095","左營區","39","760","77294","195896","94898","100998","104.4","高雄市"
"2096","楠梓區","37","803","66525","179030","88366","90664","104.4","高雄市"
"2097","三民一","41","659","33059","82016","40656","41360","104.4","高雄市"
"2098","三民二","45","1084","102000","265466","128064","137402","104.4","高雄市"
"2099","新興區","32","456","22734","52397","25228","27169","104.4","高雄市"
"2100","前金區","20","263","12549","27635","13286","14349","104.4","高雄市"
"2101","苓雅區","69","1248","72168","175326","84732","90594","104.4","高雄市"
"2102","前鎮區","59","1298","78191","193493","95484","98009","104.4","高雄市"
"2103","旗津區","13","212","10993","28891","14988","13903","104.4","高雄市"
"2104","小港區","38","697","66154","156074","77843","78231","104.4","高雄市"
"2105","鳳山一","41","1052","69935","179528","87769","91759","104.4","高雄市"
"2106","鳳山二","35","1007","66192","175573","87079","88494","104.4","高雄市"
"2107","林園區","24","525","25437","70455","35797","34658","104.4","高雄市"
"2108","大寮區","25","747","41029","111368","57269","54099","104.4","高雄市"
"2109","大樹區","18","376","13337","43222","22208","21014","104.4","高雄市"
"2110","大社區","9","175","12656","34458","17540","16918","104.4","高雄市"
"2111","仁武區","16","389","30552","81339","41565","39774","104.4","高雄市"
"2112","鳥松區","7","192","17551","43787","22300","21487","104.4","高雄市"
"2113","岡山區","33","540","34475","97768","48626","49142","104.4","高雄市"
"2114","橋頭區","17","359","13209","37296","19001","18295","104.4","高雄市"
"2115","燕巢區","11","288","10329","30271","16047","14224","104.4","高雄市"
"2116","田寮區","10","154","3398","7588","4204","3384","104.4","高雄市"
"2117","阿蓮區","12","276","9395","29495","14875","14620","104.4","高雄市"
"2118","路竹區","20","395","16783","53023","27120","25903","104.4","高雄市"
"2119","湖內區","14","260","10439","29485","15086","14399","104.4","高雄市"
"2120","茄萣區","15","339","10445","30545","15806","14739","104.4","高雄市"
"2121","永安區","6","81","5792","14090","7073","7017","104.4","高雄市"
"2122","彌陀區","12","227","6752","19763","10225","9538","104.4","高雄市"
"2123","梓官區","15","286","12508","36422","18823","17599","104.4","高雄市"
"2124","旗山區","21","381","13850","37973","19694","18279","104.4","高雄市"
"2125","美濃區","19","389","14547","41091","21519","19572","104.4","高雄市"
"2126","六龜區","12","221","5642","13604","7340","6264","104.4","高雄市"
"2127","甲仙區","7","103","2369","6353","3372","2981","104.4","高雄市"
"2128","杉林區","8","143","4813","12453","6797","5656","104.4","高雄市"
"2129","內門區","18","207","5061","15097","8174","6923","104.4","高雄市"
"2130","茂林區","3","19","579","1884","931","953","104.4","高雄市"
"2131","桃源區","8","39","1325","4264","2238","2026","104.4","高雄市"
"2132","那瑪夏區","3","20","862","3171","1644","1527","104.4","高雄市"
"2133","高雄市","891","17617","1068314","2778793","1382192","1396601","104.5","高雄市"
"2134","鹽埕區","21","232","10850","25247","12587","12660","104.5","高雄市"
"2135","鼓山區","38","722","55736","136021","66034","69987","104.5","高雄市"
"2136","左營區","39","760","77339","195981","94968","101013","104.5","高雄市"
"2137","楠梓區","37","803","66643","179138","88437","90701","104.5","高雄市"
"2138","三民一","41","659","33043","81904","40597","41307","104.5","高雄市"
"2139","三民二","45","1084","102063","265366","128020","137346","104.5","高雄市"
"2140","新興區","32","456","22732","52339","25196","27143","104.5","高雄市"
"2141","前金區","20","261","12572","27631","13271","14360","104.5","高雄市"
"2142","苓雅區","69","1243","72155","175140","84662","90478","104.5","高雄市"
"2143","前鎮區","59","1298","78246","193319","95404","97915","104.5","高雄市"
"2144","旗津區","13","212","11000","28880","14988","13892","104.5","高雄市"
"2145","小港區","38","697","66207","156130","77869","78261","104.5","高雄市"
"2146","鳳山一","41","1052","69979","179550","87720","91830","104.5","高雄市"
"2147","鳳山二","35","1007","66321","175732","87131","88601","104.5","高雄市"
"2148","林園區","24","525","25442","70418","35763","34655","104.5","高雄市"
"2149","大寮區","25","747","41095","111445","57288","54157","104.5","高雄市"
"2150","大樹區","18","376","13345","43200","22198","21002","104.5","高雄市"
"2151","大社區","9","175","12676","34456","17532","16924","104.5","高雄市"
"2152","仁武區","16","389","30627","81484","41642","39842","104.5","高雄市"
"2153","鳥松區","7","192","17573","43821","22325","21496","104.5","高雄市"
"2154","岡山區","33","540","34496","97780","48601","49179","104.5","高雄市"
"2155","橋頭區","17","359","13212","37297","19005","18292","104.5","高雄市"
"2156","燕巢區","11","288","10353","30282","16050","14232","104.5","高雄市"
"2157","田寮區","10","154","3401","7581","4202","3379","104.5","高雄市"
"2158","阿蓮區","12","276","9393","29456","14864","14592","104.5","高雄市"
"2159","路竹區","20","395","16774","53050","27131","25919","104.5","高雄市"
"2160","湖內區","14","260","10480","29552","15120","14432","104.5","高雄市"
"2161","茄萣區","15","339","10446","30527","15792","14735","104.5","高雄市"
"2162","永安區","6","81","5785","14100","7086","7014","104.5","高雄市"
"2163","彌陀區","12","227","6761","19755","10220","9535","104.5","高雄市"
"2164","梓官區","15","286","12520","36442","18830","17612","104.5","高雄市"
"2165","旗山區","21","381","13862","37973","19695","18278","104.5","高雄市"
"2166","美濃區","19","389","14544","41057","21518","19539","104.5","高雄市"
"2167","六龜區","12","221","5634","13564","7317","6247","104.5","高雄市"
"2168","甲仙區","7","103","2368","6334","3363","2971","104.5","高雄市"
"2169","杉林區","8","143","4814","12459","6801","5658","104.5","高雄市"
"2170","內門區","18","207","5062","15082","8165","6917","104.5","高雄市"
"2171","茂林區","3","19","578","1884","928","956","104.5","高雄市"
"2172","桃源區","8","39","1325","4253","2231","2022","104.5","高雄市"
"2173","那瑪夏區","3","20","862","3163","1641","1522","104.5","高雄市"
"2174","高雄市","891","17530","1069177","2778835","1381933","1396902","104.6","高雄市"
"2175","鹽埕區","21","232","10839","25220","12578","12642","104.6","高雄市"
"2176","鼓山區","38","722","55832","136152","66071","70081","104.6","高雄市"
"2177","左營區","39","710","77414","196001","94938","101063","104.6","高雄市"
"2178","楠梓區","37","803","66768","179292","88511","90781","104.6","高雄市"
"2179","三民一","41","651","33048","81811","40542","41269","104.6","高雄市"
"2180","三民二","45","1083","102127","265441","128006","137435","104.6","高雄市"
"2181","新興區","32","456","22724","52271","25175","27096","104.6","高雄市"
"2182","前金區","20","261","12554","27581","13242","14339","104.6","高雄市"
"2183","苓雅區","69","1243","72172","175013","84590","90423","104.6","高雄市"
"2184","前鎮區","59","1298","78323","193326","95354","97972","104.6","高雄市"
"2185","旗津區","13","212","11000","28854","14964","13890","104.6","高雄市"
"2186","小港區","38","697","66249","156083","77837","78246","104.6","高雄市"
"2187","鳳山一","41","1049","70047","179577","87714","91863","104.6","高雄市"
"2188","鳳山二","35","1007","66424","175933","87217","88716","104.6","高雄市"
"2189","林園區","24","517","25466","70395","35737","34658","104.6","高雄市"
"2190","大寮區","25","747","41159","111500","57290","54210","104.6","高雄市"
"2191","大樹區","18","376","13354","43152","22167","20985","104.6","高雄市"
"2192","大社區","9","175","12680","34473","17551","16922","104.6","高雄市"
"2193","仁武區","16","389","30681","81636","41717","39919","104.6","高雄市"
"2194","鳥松區","7","192","17588","43789","22302","21487","104.6","高雄市"
"2195","岡山區","33","533","34522","97745","48597","49148","104.6","高雄市"
"2196","橋頭區","17","359","13219","37306","19017","18289","104.6","高雄市"
"2197","燕巢區","11","278","10361","30259","16040","14219","104.6","高雄市"
"2198","田寮區","10","154","3394","7545","4182","3363","104.6","高雄市"
"2199","阿蓮區","12","276","9376","29428","14849","14579","104.6","高雄市"
"2200","路竹區","20","395","16783","53063","27130","25933","104.6","高雄市"
"2201","湖內區","14","260","10493","29543","15122","14421","104.6","高雄市"
"2202","茄萣區","15","339","10447","30528","15784","14744","104.6","高雄市"
"2203","永安區","6","81","5789","14105","7084","7021","104.6","高雄市"
"2204","彌陀區","12","227","6756","19731","10213","9518","104.6","高雄市"
"2205","梓官區","15","286","12532","36449","18834","17615","104.6","高雄市"
"2206","旗山區","21","381","13862","37938","19676","18262","104.6","高雄市"
"2207","美濃區","19","389","14546","41029","21497","19532","104.6","高雄市"
"2208","六龜區","12","221","5638","13559","7312","6247","104.6","高雄市"
"2209","甲仙區","7","103","2366","6326","3357","2969","104.6","高雄市"
"2210","杉林區","8","143","4819","12437","6797","5640","104.6","高雄市"
"2211","內門區","18","207","5062","15053","8144","6909","104.6","高雄市"
"2212","茂林區","3","19","579","1886","930","956","104.6","高雄市"
"2213","桃源區","8","39","1323","4244","2227","2017","104.6","高雄市"
"2214","那瑪夏區","3","20","861","3161","1638","1523","104.6","高雄市"
"2215","高雄市","891","17366","1069713","2778276","1381604","1396672","104.7","高雄市"
"2216","鹽埕區","21","228","10837","25174","12553","12621","104.7","高雄市"
"2217","鼓山區","38","719","55887","136330","66149","70181","104.7","高雄市"
"2218","左營區","39","710","77440","195992","94885","101107","104.7","高雄市"
"2219","楠梓區","37","803","66880","179328","88520","90808","104.7","高雄市"
"2220","三民一","41","651","33044","81720","40518","41202","104.7","高雄市"
"2221","三民二","45","1083","102162","265259","127917","137342","104.7","高雄市"
"2222","新興區","32","453","22715","52163","25141","27022","104.7","高雄市"
"2223","前金區","20","261","12556","27534","13235","14299","104.7","高雄市"
"2224","苓雅區","69","1243","72165","174868","84532","90336","104.7","高雄市"
"2225","前鎮區","59","1298","78345","193149","95252","97897","104.7","高雄市"
"2226","旗津區","13","212","10995","28803","14939","13864","104.7","高雄市"
"2227","小港區","38","697","66278","155999","77814","78185","104.7","高雄市"
"2228","鳳山一","41","1050","70066","179540","87660","91880","104.7","高雄市"
"2229","鳳山二","35","1007","66501","176006","87254","88752","104.7","高雄市"
"2230","林園區","24","517","25466","70377","35724","34653","104.7","高雄市"
"2231","大寮區","25","747","41231","111599","57323","54276","104.7","高雄市"
"2232","大樹區","18","370","13363","43156","22180","20976","104.7","高雄市"
"2233","大社區","9","175","12707","34516","17576","16940","104.7","高雄市"
"2234","仁武區","16","388","30766","81810","41787","40023","104.7","高雄市"
"2235","鳥松區","7","191","17603","43806","22310","21496","104.7","高雄市"
"2236","岡山區","33","531","34518","97746","48626","49120","104.7","高雄市"
"2237","橋頭區","17","347","13226","37349","19039","18310","104.7","高雄市"
"2238","燕巢區","11","278","10364","30239","16023","14216","104.7","高雄市"
"2239","田寮區","10","140","3393","7532","4177","3355","104.7","高雄市"
"2240","阿蓮區","12","275","9363","29377","14820","14557","104.7","高雄市"
"2241","路竹區","20","392","16779","53039","27122","25917","104.7","高雄市"
"2242","湖內區","14","255","10499","29551","15120","14431","104.7","高雄市"
"2243","茄萣區","15","304","10446","30560","15802","14758","104.7","高雄市"
"2244","永安區","6","81","5778","14109","7078","7031","104.7","高雄市"
"2245","彌陀區","12","206","6761","19720","10200","9520","104.7","高雄市"
"2246","梓官區","15","273","12543","36465","18848","17617","104.7","高雄市"
"2247","旗山區","21","377","13850","37862","19628","18234","104.7","高雄市"
"2248","美濃區","19","382","14531","40966","21480","19486","104.7","高雄市"
"2249","六龜區","12","215","5642","13550","7302","6248","104.7","高雄市"
"2250","甲仙區","7","91","2372","6326","3357","2969","104.7","高雄市"
"2251","杉林區","8","142","4816","12428","6793","5635","104.7","高雄市"
"2252","內門區","18","196","5059","15051","8137","6914","104.7","高雄市"
"2253","茂林區","3","19","579","1879","928","951","104.7","高雄市"
"2254","桃源區","8","39","1326","4243","2222","2021","104.7","高雄市"
"2255","那瑪夏區","3","20","861","3155","1633","1522","104.7","高雄市"
"2256","高雄市","891","17341","1070753","2777948","1381252","1396696","104.8","高雄市"
"2257","鹽埕區","21","228","10838","25126","12522","12604","104.8","高雄市"
"2258","鼓山區","38","719","55990","136388","66182","70206","104.8","高雄市"
"2259","左營區","39","710","77495","195870","94780","101090","104.8","高雄市"
"2260","楠梓區","37","803","67025","179442","88551","90891","104.8","高雄市"
"2261","三民一","41","651","33055","81605","40429","41176","104.8","高雄市"
"2262","三民二","45","1083","102225","265133","127862","137271","104.8","高雄市"
"2263","新興區","32","453","22720","52084","25108","26976","104.8","高雄市"
"2264","前金區","20","261","12561","27509","13234","14275","104.8","高雄市"
"2265","苓雅區","69","1242","72211","174818","84502","90316","104.8","高雄市"
"2266","前鎮區","59","1298","78409","193009","95174","97835","104.8","高雄市"
"2267","旗津區","13","212","11008","28832","14955","13877","104.8","高雄市"
"2268","小港區","38","697","66342","155996","77813","78183","104.8","高雄市"
"2269","鳳山一","41","1050","70098","179404","87587","91817","104.8","高雄市"
"2270","鳳山二","35","1007","66642","176164","87302","88862","104.8","高雄市"
"2271","林園區","24","517","25482","70339","35702","34637","104.8","高雄市"
"2272","大寮區","25","724","41253","111638","57316","54322","104.8","高雄市"
"2273","大樹區","18","370","13384","43145","22172","20973","104.8","高雄市"
"2274","大社區","9","175","12709","34525","17579","16946","104.8","高雄市"
"2275","仁武區","16","388","30865","82000","41877","40123","104.8","高雄市"
"2276","鳥松區","7","191","17629","43843","22333","21510","104.8","高雄市"
"2277","岡山區","33","530","34553","97769","48617","49152","104.8","高雄市"
"2278","橋頭區","17","347","13244","37363","19051","18312","104.8","高雄市"
"2279","燕巢區","11","278","10369","30229","16013","14216","104.8","高雄市"
"2280","田寮區","10","140","3390","7526","4175","3351","104.8","高雄市"
"2281","阿蓮區","12","275","9361","29368","14807","14561","104.8","高雄市"
"2282","路竹區","20","392","16791","53050","27109","25941","104.8","高雄市"
"2283","湖內區","14","255","10518","29567","15124","14443","104.8","高雄市"
"2284","茄萣區","15","304","10452","30582","15811","14771","104.8","高雄市"
"2285","永安區","6","81","5778","14126","7084","7042","104.8","高雄市"
"2286","彌陀區","12","206","6762","19689","10193","9496","104.8","高雄市"
"2287","梓官區","15","273","12548","36458","18837","17621","104.8","高雄市"
"2288","旗山區","21","377","13861","37861","19632","18229","104.8","高雄市"
"2289","美濃區","19","382","14534","40931","21464","19467","104.8","高雄市"
"2290","六龜區","12","215","5642","13524","7300","6224","104.8","高雄市"
"2291","甲仙區","7","91","2368","6320","3358","2962","104.8","高雄市"
"2292","杉林區","8","142","4823","12425","6795","5630","104.8","高雄市"
"2293","內門區","18","196","5059","15036","8131","6905","104.8","高雄市"
"2294","茂林區","3","19","579","1882","930","952","104.8","高雄市"
"2295","桃源區","8","39","1321","4228","2211","2017","104.8","高雄市"
"2296","那瑪夏區","3","20","859","3144","1630","1514","104.8","高雄市"
"2297","高雄市","891","17336","1072321","2777870","1381100","1396770","104.9","高雄市"
"2298","鹽埕區","21","228","10841","25067","12478","12589","104.9","高雄市"
"2299","鼓山區","38","719","56142","136442","66190","70252","104.9","高雄市"
"2300","左營區","39","710","77612","195972","94832","101140","104.9","高雄市"
"2301","楠梓區","37","803","67264","179629","88595","91034","104.9","高雄市"
"2302","三民一","41","651","33078","81512","40392","41120","104.9","高雄市"
"2303","三民二","45","1083","102310","265028","127832","137196","104.9","高雄市"
"2304","新興區","32","453","22721","52034","25084","26950","104.9","高雄市"
"2305","前金區","20","261","12579","27497","13232","14265","104.9","高雄市"
"2306","苓雅區","69","1241","72301","174700","84461","90239","104.9","高雄市"
"2307","前鎮區","59","1298","78447","192906","95091","97815","104.9","高雄市"
"2308","旗津區","13","212","11044","28921","15001","13920","104.9","高雄市"
"2309","小港區","38","697","66398","156013","77803","78210","104.9","高雄市"
"2310","鳳山一","41","1046","70216","179419","87594","91825","104.9","高雄市"
"2311","鳳山二","35","1007","66810","176347","87375","88972","104.9","高雄市"
"2312","林園區","24","517","25505","70303","35688","34615","104.9","高雄市"
"2313","大寮區","25","724","41307","111619","57323","54296","104.9","高雄市"
"2314","大樹區","18","370","13391","43115","22161","20954","104.9","高雄市"
"2315","大社區","9","175","12734","34537","17595","16942","104.9","高雄市"
"2316","仁武區","16","388","30991","82134","41929","40205","104.9","高雄市"
"2317","鳥松區","7","191","17656","43844","22312","21532","104.9","高雄市"
"2318","岡山區","33","530","34624","97741","48611","49130","104.9","高雄市"
"2319","橋頭區","17","347","13274","37334","19021","18313","104.9","高雄市"
"2320","燕巢區","11","278","10377","30223","16017","14206","104.9","高雄市"
"2321","田寮區","10","140","3379","7521","4175","3346","104.9","高雄市"
"2322","阿蓮區","12","275","9366","29366","14807","14559","104.9","高雄市"
"2323","路竹區","20","392","16808","53023","27092","25931","104.9","高雄市"
"2324","湖內區","14","255","10557","29600","15130","14470","104.9","高雄市"
"2325","茄萣區","15","304","10449","30547","15796","14751","104.9","高雄市"
"2326","永安區","6","81","5745","14119","7084","7035","104.9","高雄市"
"2327","彌陀區","12","206","6760","19669","10172","9497","104.9","高雄市"
"2328","梓官區","15","273","12554","36438","18824","17614","104.9","高雄市"
"2329","旗山區","21","377","13875","37856","19633","18223","104.9","高雄市"
"2330","美濃區","19","382","14540","40901","21451","19450","104.9","高雄市"
"2331","六龜區","12","215","5645","13514","7292","6222","104.9","高雄市"
"2332","甲仙區","7","91","2367","6292","3346","2946","104.9","高雄市"
"2333","杉林區","8","142","4823","12422","6791","5631","104.9","高雄市"
"2334","內門區","18","196","5068","15015","8124","6891","104.9","高雄市"
"2335","茂林區","3","19","580","1883","928","955","104.9","高雄市"
"2336","桃源區","8","39","1324","4230","2215","2015","104.9","高雄市"
"2337","那瑪夏區","3","20","859","3137","1623","1514","104.9","高雄市"
"2338","高雄市","891","17335","1072344","2778249","1381115","1397134","104.10","高雄市"
"2339","鹽埕區","21","228","10830","25027","12459","12568","104.10","高雄市"
"2340","鼓山區","38","719","56142","136537","66236","70301","104.10","高雄市"
"2341","左營區","39","710","77596","196083","94867","101216","104.10","高雄市"
"2342","楠梓區","37","803","67288","179678","88585","91093","104.10","高雄市"
"2343","三民一","41","651","33060","81442","40371","41071","104.10","高雄市"
"2344","三民二","45","1083","102290","265009","127846","137163","104.10","高雄市"
"2345","新興區","32","453","22709","52000","25064","26936","104.10","高雄市"
"2346","前金區","20","261","12551","27459","13228","14231","104.10","高雄市"
"2347","苓雅區","69","1241","72282","174701","84444","90257","104.10","高雄市"
"2348","前鎮區","59","1298","78422","192798","95038","97760","104.10","高雄市"
"2349","旗津區","13","212","11057","28959","15013","13946","104.10","高雄市"
"2350","小港區","38","697","66449","156081","77792","78289","104.10","高雄市"
"2351","鳳山一","41","1046","70196","179471","87594","91877","104.10","高雄市"
"2352","鳳山二","35","1007","66857","176492","87454","89038","104.10","高雄市"
"2353","林園區","24","517","25518","70332","35707","34625","104.10","高雄市"
"2354","大寮區","25","724","41296","111558","57310","54248","104.10","高雄市"
"2355","大樹區","18","370","13389","43130","22168","20962","104.10","高雄市"
"2356","大社區","9","174","12730","34536","17591","16945","104.10","高雄市"
"2357","仁武區","16","388","31065","82351","42028","40323","104.10","高雄市"
"2358","鳥松區","7","191","17691","43892","22329","21563","104.10","高雄市"
"2359","岡山區","33","530","34636","97799","48617","49182","104.10","高雄市"
"2360","橋頭區","17","347","13256","37290","18988","18302","104.10","高雄市"
"2361","燕巢區","11","278","10381","30192","15995","14197","104.10","高雄市"
"2362","田寮區","10","140","3370","7500","4163","3337","104.10","高雄市"
"2363","阿蓮區","12","275","9365","29366","14801","14565","104.10","高雄市"
"2364","路竹區","20","392","16807","53050","27096","25954","104.10","高雄市"
"2365","湖內區","14","255","10553","29597","15130","14467","104.10","高雄市"
"2366","茄萣區","15","304","10453","30564","15789","14775","104.10","高雄市"
"2367","永安區","6","81","5743","14134","7096","7038","104.10","高雄市"
"2368","彌陀區","12","206","6756","19669","10163","9506","104.10","高雄市"
"2369","梓官區","15","273","12547","36418","18819","17599","104.10","高雄市"
"2370","旗山區","21","377","13861","37809","19605","18204","104.10","高雄市"
"2371","美濃區","19","382","14542","40867","21442","19425","104.10","高雄市"
"2372","六龜區","12","215","5645","13509","7289","6220","104.10","高雄市"
"2373","甲仙區","7","91","2362","6282","3339","2943","104.10","高雄市"
"2374","杉林區","8","142","4818","12408","6776","5632","104.10","高雄市"
"2375","內門區","18","196","5070","15011","8117","6894","104.10","高雄市"
"2376","茂林區","3","19","580","1886","931","955","104.10","高雄市"
"2377","桃源區","8","39","1322","4225","2212","2013","104.10","高雄市"
"2378","那瑪夏區","3","20","859","3137","1623","1514","104.10","高雄市"
"2379","高雄市","891","17334","1072598","2778512","1381020","1397492","104.11","高雄市"
"2380","鹽埕區","21","228","10841","25029","12456","12573","104.11","高雄市"
"2381","鼓山區","38","719","56162","136594","66222","70372","104.11","高雄市"
"2382","左營區","39","710","77584","196156","94879","101277","104.11","高雄市"
"2383","楠梓區","37","803","67352","179802","88614","91188","104.11","高雄市"
"2384","三民一","41","651","33036","81340","40299","41041","104.11","高雄市"
"2385","三民二","45","1083","102298","265021","127845","137176","104.11","高雄市"
"2386","新興區","32","453","22702","51955","25047","26908","104.11","高雄市"
"2387","前金區","20","261","12547","27405","13206","14199","104.11","高雄市"
"2388","苓雅區","69","1240","72264","174609","84390","90219","104.11","高雄市"
"2389","前鎮區","59","1298","78413","192732","94990","97742","104.11","高雄市"
"2390","旗津區","13","212","11060","29010","15046","13964","104.11","高雄市"
"2391","小港區","38","697","66463","156145","77811","78334","104.11","高雄市"
"2392","鳳山一","41","1046","70191","179458","87571","91887","104.11","高雄市"
"2393","鳳山二","35","1007","66894","176550","87465","89085","104.11","高雄市"
"2394","林園區","24","517","25541","70344","35703","34641","104.11","高雄市"
"2395","大寮區","25","724","41304","111609","57340","54269","104.11","高雄市"
"2396","大樹區","18","370","13392","43160","22180","20980","104.11","高雄市"
"2397","大社區","9","174","12735","34557","17596","16961","104.11","高雄市"
"2398","仁武區","16","388","31129","82492","42063","40429","104.11","高雄市"
"2399","鳥松區","7","191","17712","43943","22342","21601","104.11","高雄市"
"2400","岡山區","33","530","34649","97781","48624","49157","104.11","高雄市"
"2401","橋頭區","17","347","13267","37278","18988","18290","104.11","高雄市"
"2402","燕巢區","11","278","10391","30163","15975","14188","104.11","高雄市"
"2403","田寮區","10","140","3367","7488","4157","3331","104.11","高雄市"
"2404","阿蓮區","12","275","9358","29353","14795","14558","104.11","高雄市"
"2405","路竹區","20","392","16824","53039","27094","25945","104.11","高雄市"
"2406","湖內區","14","255","10556","29621","15139","14482","104.11","高雄市"
"2407","茄萣區","15","304","10460","30557","15792","14765","104.11","高雄市"
"2408","永安區","6","81","5741","14149","7105","7044","104.11","高雄市"
"2409","彌陀區","12","206","6754","19658","10161","9497","104.11","高雄市"
"2410","梓官區","15","273","12550","36424","18817","17607","104.11","高雄市"
"2411","旗山區","21","377","13863","37794","19593","18201","104.11","高雄市"
"2412","美濃區","19","382","14547","40853","21434","19419","104.11","高雄市"
"2413","六龜區","12","215","5639","13480","7273","6207","104.11","高雄市"
"2414","甲仙區","7","91","2361","6282","3339","2943","104.11","高雄市"
"2415","杉林區","8","142","4814","12407","6770","5637","104.11","高雄市"
"2416","內門區","18","196","5075","15009","8120","6889","104.11","高雄市"
"2417","茂林區","3","19","580","1886","931","955","104.11","高雄市"
"2418","桃源區","8","39","1323","4237","2220","2017","104.11","高雄市"
"2419","那瑪夏區","3","20","859","3142","1628","1514","104.11","高雄市"
"2420","高雄市","891","17334","1072939","2778918","1380989","1397929","104.12","高雄市"
"2421","鹽埕區","21","228","10833","25032","12458","12574","104.12","高雄市"
"2422","鼓山區","38","719","56184","136665","66270","70395","104.12","高雄市"
"2423","左營區","39","710","77616","196244","94865","101379","104.12","高雄市"
"2424","楠梓區","37","803","67419","179931","88660","91271","104.12","高雄市"
"2425","三民一","41","651","33014","81241","40250","40991","104.12","高雄市"
"2426","三民二","45","1083","102251","264928","127813","137115","104.12","高雄市"
"2427","新興區","32","453","22684","51955","25061","26894","104.12","高雄市"
"2428","前金區","20","261","12547","27388","13192","14196","104.12","高雄市"
"2429","苓雅區","69","1240","72263","174515","84324","90191","104.12","高雄市"
"2430","前鎮區","59","1298","78388","192593","94900","97693","104.12","高雄市"
"2431","旗津區","13","212","11054","29008","15043","13965","104.12","高雄市"
"2432","小港區","38","697","66516","156256","77842","78414","104.12","高雄市"
"2433","鳳山一","41","1046","70221","179559","87594","91965","104.12","高雄市"
"2434","鳳山二","35","1007","66941","176761","87556","89205","104.12","高雄市"
"2435","林園區","24","517","25559","70401","35727","34674","104.12","高雄市"
"2436","大寮區","25","724","41360","111663","57346","54317","104.12","高雄市"
"2437","大樹區","18","370","13403","43161","22181","20980","104.12","高雄市"
"2438","大社區","9","174","12735","34566","17593","16973","104.12","高雄市"
"2439","仁武區","16","388","31183","82614","42119","40495","104.12","高雄市"
"2440","鳥松區","7","191","17746","43965","22353","21612","104.12","高雄市"
"2441","岡山區","33","530","34654","97827","48635","49192","104.12","高雄市"
"2442","橋頭區","17","347","13268","37317","19002","18315","104.12","高雄市"
"2443","燕巢區","11","278","10395","30124","15956","14168","104.12","高雄市"
"2444","田寮區","10","140","3360","7473","4151","3322","104.12","高雄市"
"2445","阿蓮區","12","275","9361","29319","14777","14542","104.12","高雄市"
"2446","路竹區","20","392","16818","53033","27086","25947","104.12","高雄市"
"2447","湖內區","14","255","10571","29615","15129","14486","104.12","高雄市"
"2448","茄萣區","15","304","10473","30551","15791","14760","104.12","高雄市"
"2449","永安區","6","81","5743","14152","7097","7055","104.12","高雄市"
"2450","彌陀區","12","206","6754","19655","10154","9501","104.12","高雄市"
"2451","梓官區","15","273","12567","36429","18829","17600","104.12","高雄市"
"2452","旗山區","21","377","13862","37770","19576","18194","104.12","高雄市"
"2453","美濃區","19","382","14552","40810","21410","19400","104.12","高雄市"
"2454","六龜區","12","215","5639","13467","7261","6206","104.12","高雄市"
"2455","甲仙區","7","91","2362","6291","3341","2950","104.12","高雄市"
"2456","杉林區","8","142","4805","12383","6765","5618","104.12","高雄市"
"2457","內門區","18","196","5074","14978","8100","6878","104.12","高雄市"
"2458","茂林區","3","19","582","1890","932","958","104.12","高雄市"
"2459","桃源區","8","39","1324","4239","2221","2018","104.12","高雄市"
"2460","那瑪夏區","3","20","858","3149","1629","1520","104.12","高雄市"
"2461","高雄市","891","17334","1073237","2778729","1380719","1398010","105.1","高雄市"
"2462","鹽埕區","21","228","10830","24997","12436","12561","105.1","高雄市"
"2463","鼓山區","38","719","56217","136679","66292","70387","105.1","高雄市"
"2464","左營區","39","710","77645","196362","94917","101445","105.1","高雄市"
"2465","楠梓區","37","803","67517","180113","88728","91385","105.1","高雄市"
"2466","三民一","41","651","33003","81187","40192","40995","105.1","高雄市"
"2467","三民二","45","1083","102237","264781","127748","137033","105.1","高雄市"
"2468","新興區","32","453","22678","51953","25052","26901","105.1","高雄市"
"2469","前金區","20","261","12515","27369","13168","14201","105.1","高雄市"
"2470","苓雅區","69","1240","72247","174419","84279","90140","105.1","高雄市"
"2471","前鎮區","59","1298","78344","192484","94816","97668","105.1","高雄市"
"2472","旗津區","13","212","11063","28992","15027","13965","105.1","高雄市"
"2473","小港區","38","697","66547","156220","77842","78378","105.1","高雄市"
"2474","鳳山一","41","1046","70275","179625","87607","92018","105.1","高雄市"
"2475","鳳山二","35","1007","66985","176882","87581","89301","105.1","高雄市"
"2476","林園區","24","517","25573","70423","35723","34700","105.1","高雄市"
"2477","大寮區","25","724","41376","111675","57357","54318","105.1","高雄市"
"2478","大樹區","18","370","13412","43158","22178","20980","105.1","高雄市"
"2479","大社區","9","174","12738","34585","17591","16994","105.1","高雄市"
"2480","仁武區","16","388","31239","82696","42156","40540","105.1","高雄市"
"2481","鳥松區","7","191","17768","43937","22350","21587","105.1","高雄市"
"2482","岡山區","33","530","34638","97843","48636","49207","105.1","高雄市"
"2483","橋頭區","17","347","13277","37328","19004","18324","105.1","高雄市"
"2484","燕巢區","11","278","10393","30074","15923","14151","105.1","高雄市"
"2485","田寮區","10","140","3359","7457","4140","3317","105.1","高雄市"
"2486","阿蓮區","12","275","9359","29297","14774","14523","105.1","高雄市"
"2487","路竹區","20","392","16834","53081","27118","25963","105.1","高雄市"
"2488","湖內區","14","255","10579","29604","15125","14479","105.1","高雄市"
"2489","茄萣區","15","304","10471","30498","15768","14730","105.1","高雄市"
"2490","永安區","6","81","5735","14118","7083","7035","105.1","高雄市"
"2491","彌陀區","12","206","6756","19657","10147","9510","105.1","高雄市"
"2492","梓官區","15","273","12579","36417","18814","17603","105.1","高雄市"
"2493","旗山區","21","377","13853","37749","19558","18191","105.1","高雄市"
"2494","美濃區","19","382","14565","40776","21390","19386","105.1","高雄市"
"2495","六龜區","12","215","5627","13435","7239","6196","105.1","高雄市"
"2496","甲仙區","7","91","2361","6252","3324","2928","105.1","高雄市"
"2497","杉林區","8","142","4804","12382","6766","5616","105.1","高雄市"
"2498","內門區","18","196","5074","14953","8093","6860","105.1","高雄市"
"2499","茂林區","3","19","582","1893","934","959","105.1","高雄市"
"2500","桃源區","8","39","1325","4232","2216","2016","105.1","高雄市"
"2501","那瑪夏區","3","20","857","3146","1627","1519","105.1","高雄市"
"2502","高雄市","891","17334","1073422","2778574","1380388","1398186","105.2","高雄市"
"2503","鹽埕區","21","228","10821","24983","12422","12561","105.2","高雄市"
"2504","鼓山區","38","719","56274","136774","66351","70423","105.2","高雄市"
"2505","左營區","39","710","77676","196401","94876","101525","105.2","高雄市"
"2506","楠梓區","37","803","67579","180301","88803","91498","105.2","高雄市"
"2507","三民一","41","651","33007","81165","40165","41000","105.2","高雄市"
"2508","三民二","45","1083","102217","264720","127702","137018","105.2","高雄市"
"2509","新興區","32","453","22654","51871","25020","26851","105.2","高雄市"
"2510","前金區","20","261","12505","27367","13152","14215","105.2","高雄市"
"2511","苓雅區","69","1240","72230","174319","84216","90103","105.2","高雄市"
"2512","前鎮區","59","1298","78328","192330","94747","97583","105.2","高雄市"
"2513","旗津區","13","212","11069","28948","15002","13946","105.2","高雄市"
"2514","小港區","38","697","66570","156292","77859","78433","105.2","高雄市"
"2515","鳳山一","41","1046","70299","179700","87634","92066","105.2","高雄市"
"2516","鳳山二","35","1007","67040","177030","87664","89366","105.2","高雄市"
"2517","林園區","24","517","25575","70400","35699","34701","105.2","高雄市"
"2518","大寮區","25","724","41397","111681","57363","54318","105.2","高雄市"
"2519","大樹區","18","370","13419","43144","22163","20981","105.2","高雄市"
"2520","大社區","9","174","12732","34570","17568","17002","105.2","高雄市"
"2521","仁武區","16","388","31276","82804","42192","40612","105.2","高雄市"
"2522","鳥松區","7","191","17752","43911","22324","21587","105.2","高雄市"
"2523","岡山區","33","530","34647","97830","48634","49196","105.2","高雄市"
"2524","橋頭區","17","347","13275","37357","19028","18329","105.2","高雄市"
"2525","燕巢區","11","278","10386","30047","15912","14135","105.2","高雄市"
"2526","田寮區","10","140","3352","7430","4124","3306","105.2","高雄市"
"2527","阿蓮區","12","275","9361","29271","14765","14506","105.2","高雄市"
"2528","路竹區","20","392","16818","53060","27102","25958","105.2","高雄市"
"2529","湖內區","14","255","10586","29581","15094","14487","105.2","高雄市"
"2530","茄萣區","15","304","10466","30461","15740","14721","105.2","高雄市"
"2531","永安區","6","81","5729","14116","7082","7034","105.2","高雄市"
"2532","彌陀區","12","206","6762","19659","10138","9521","105.2","高雄市"
"2533","梓官區","15","273","12567","36367","18779","17588","105.2","高雄市"
"2534","旗山區","21","377","13836","37682","19526","18156","105.2","高雄市"
"2535","美濃區","19","382","14584","40768","21374","19394","105.2","高雄市"
"2536","六龜區","12","215","5627","13421","7228","6193","105.2","高雄市"
"2537","甲仙區","7","91","2357","6252","3329","2923","105.2","高雄市"
"2538","杉林區","8","142","4803","12363","6756","5607","105.2","高雄市"
"2539","內門區","18","196","5077","14928","8079","6849","105.2","高雄市"
"2540","茂林區","3","19","584","1893","933","960","105.2","高雄市"
"2541","桃源區","8","39","1328","4227","2218","2009","105.2","高雄市"
"2542","那瑪夏區","3","20","857","3150","1625","1525","105.2","高雄市"
"2543","高雄市","891","17334","1074044","2778240","1380105","1398135","105.3","高雄市"
"2544","鹽埕區","21","228","10802","24903","12371","12532","105.3","高雄市"
"2545","鼓山區","38","719","56292","136795","66348","70447","105.3","高雄市"
"2546","左營區","39","710","77777","196594","94963","101631","105.3","高雄市"
"2547","楠梓區","37","803","67704","180456","88856","91600","105.3","高雄市"
"2548","三民一","41","651","32983","81113","40123","40990","105.3","高雄市"
"2549","三民二","45","1083","102236","264683","127676","137007","105.3","高雄市"
"2550","新興區","32","453","22648","51853","25003","26850","105.3","高雄市"
"2551","前金區","20","261","12495","27351","13142","14209","105.3","高雄市"
"2552","苓雅區","69","1240","72237","174078","84060","90018","105.3","高雄市"
"2553","前鎮區","59","1298","78330","192153","94666","97487","105.3","高雄市"
"2554","旗津區","13","212","11070","28895","14970","13925","105.3","高雄市"
"2555","小港區","38","697","66612","156317","77854","78463","105.3","高雄市"
"2556","鳳山一","41","1046","70371","179677","87606","92071","105.3","高雄市"
"2557","鳳山二","35","1007","67136","177134","87726","89408","105.3","高雄市"
"2558","林園區","24","517","25585","70361","35683","34678","105.3","高雄市"
"2559","大寮區","25","724","41436","111709","57395","54314","105.3","高雄市"
"2560","大樹區","18","370","13443","43148","22170","20978","105.3","高雄市"
"2561","大社區","9","174","12741","34613","17606","17007","105.3","高雄市"
"2562","仁武區","16","388","31351","82885","42216","40669","105.3","高雄市"
"2563","鳥松區","7","191","17773","43978","22363","21615","105.3","高雄市"
"2564","岡山區","33","530","34653","97804","48619","49185","105.3","高雄市"
"2565","橋頭區","17","347","13284","37356","19028","18328","105.3","高雄市"
"2566","燕巢區","11","278","10395","30027","15903","14124","105.3","高雄市"
"2567","田寮區","10","140","3349","7416","4120","3296","105.3","高雄市"
"2568","阿蓮區","12","275","9361","29246","14743","14503","105.3","高雄市"
"2569","路竹區","20","392","16843","53094","27117","25977","105.3","高雄市"
"2570","湖內區","14","255","10597","29584","15098","14486","105.3","高雄市"
"2571","茄萣區","15","304","10454","30418","15718","14700","105.3","高雄市"
"2572","永安區","6","81","5731","14086","7081","7005","105.3","高雄市"
"2573","彌陀區","12","206","6750","19634","10122","9512","105.3","高雄市"
"2574","梓官區","15","273","12553","36336","18769","17567","105.3","高雄市"
"2575","旗山區","21","377","13828","37665","19517","18148","105.3","高雄市"
"2576","美濃區","19","382","14593","40720","21344","19376","105.3","高雄市"
"2577","六龜區","12","215","5618","13398","7214","6184","105.3","高雄市"
"2578","甲仙區","7","91","2353","6244","3325","2919","105.3","高雄市"
"2579","杉林區","8","142","4815","12364","6753","5611","105.3","高雄市"
"2580","內門區","18","196","5077","14886","8061","6825","105.3","高雄市"
"2581","茂林區","3","19","583","1897","933","964","105.3","高雄市"
"2582","桃源區","8","39","1329","4221","2219","2002","105.3","高雄市"
"2583","那瑪夏區","3","20","856","3148","1624","1524","105.3","高雄市"
"2584","高雄市","891","17334","1074436","2778107","1379945","1398162","105.4","高雄市"
"2585","鹽埕區","21","228","10802","24877","12360","12517","105.4","高雄市"
"2586","鼓山區","38","719","56337","136888","66386","70502","105.4","高雄市"
"2587","左營區","39","710","77800","196610","94953","101657","105.4","高雄市"
"2588","楠梓區","37","803","67795","180508","88885","91623","105.4","高雄市"
"2589","三民一","41","651","32972","81025","40090","40935","105.4","高雄市"
"2590","三民二","45","1083","102231","264619","127611","137008","105.4","高雄市"
"2591","新興區","32","453","22656","51815","24986","26829","105.4","高雄市"
"2592","前金區","20","261","12495","27356","13142","14214","105.4","高雄市"
"2593","苓雅區","69","1240","72217","174012","84014","89998","105.4","高雄市"
"2594","前鎮區","59","1298","78322","192071","94630","97441","105.4","高雄市"
"2595","旗津區","13","212","11077","28891","14968","13923","105.4","高雄市"
"2596","小港區","38","697","66637","156285","77831","78454","105.4","高雄市"
"2597","鳳山一","41","1046","70417","179781","87676","92105","105.4","高雄市"
"2598","鳳山二","35","1007","67141","177159","87715","89444","105.4","高雄市"
"2599","林園區","24","517","25587","70335","35666","34669","105.4","高雄市"
"2600","大寮區","25","724","41458","111767","57389","54378","105.4","高雄市"
"2601","大樹區","18","370","13455","43153","22163","20990","105.4","高雄市"
"2602","大社區","9","174","12745","34613","17608","17005","105.4","高雄市"
"2603","仁武區","16","388","31431","83004","42260","40744","105.4","高雄市"
"2604","鳥松區","7","191","17784","43958","22361","21597","105.4","高雄市"
"2605","岡山區","33","530","34679","97822","48616","49206","105.4","高雄市"
"2606","橋頭區","17","347","13289","37330","19023","18307","105.4","高雄市"
"2607","燕巢區","11","278","10412","30012","15893","14119","105.4","高雄市"
"2608","田寮區","10","140","3343","7406","4113","3293","105.4","高雄市"
"2609","阿蓮區","12","275","9374","29255","14757","14498","105.4","高雄市"
"2610","路竹區","20","392","16846","53088","27115","25973","105.4","高雄市"
"2611","湖內區","14","255","10604","29618","15118","14500","105.4","高雄市"
"2612","茄萣區","15","304","10457","30396","15709","14687","105.4","高雄市"
"2613","永安區","6","81","5727","14074","7079","6995","105.4","高雄市"
"2614","彌陀區","12","206","6754","19642","10124","9518","105.4","高雄市"
"2615","梓官區","15","273","12559","36336","18772","17564","105.4","高雄市"
"2616","旗山區","21","377","13820","37651","19523","18128","105.4","高雄市"
"2617","美濃區","19","382","14596","40672","21322","19350","105.4","高雄市"
"2618","六龜區","12","215","5608","13369","7199","6170","105.4","高雄市"
"2619","甲仙區","7","91","2358","6251","3324","2927","105.4","高雄市"
"2620","杉林區","8","142","4811","12345","6735","5610","105.4","高雄市"
"2621","內門區","18","196","5077","14857","8052","6805","105.4","高雄市"
"2622","茂林區","3","19","581","1896","934","962","105.4","高雄市"
"2623","桃源區","8","39","1328","4218","2218","2000","105.4","高雄市"
"2624","那瑪夏區","3","20","854","3142","1625","1517","105.4","高雄市"
"2625","高雄市","891","17334","1075353","2777784","1379620","1398164","105.5","高雄市"
"2626","鹽埕區","21","228","10803","24866","12339","12527","105.5","高雄市"
"2627","鼓山區","38","719","56424","136995","66415","70580","105.5","高雄市"
"2628","左營區","39","710","77895","196663","94964","101699","105.5","高雄市"
"2629","楠梓區","37","803","67951","180692","88959","91733","105.5","高雄市"
"2630","三民一","41","651","32950","80940","40030","40910","105.5","高雄市"
"2631","三民二","45","1083","102307","264489","127508","136981","105.5","高雄市"
"2632","新興區","32","453","22651","51784","24971","26813","105.5","高雄市"
"2633","前金區","20","261","12481","27281","13102","14179","105.5","高雄市"
"2634","苓雅區","69","1240","72225","173789","83911","89878","105.5","高雄市"
"2635","前鎮區","59","1298","78293","191954","94557","97397","105.5","高雄市"
"2636","旗津區","13","212","11079","28870","14962","13908","105.5","高雄市"
"2637","小港區","38","697","66709","156340","77838","78502","105.5","高雄市"
"2638","鳳山一","41","1046","70495","179786","87693","92093","105.5","高雄市"
"2639","鳳山二","35","1007","67223","177234","87728","89506","105.5","高雄市"
"2640","林園區","24","517","25621","70320","35652","34668","105.5","高雄市"
"2641","大寮區","25","724","41495","111760","57397","54363","105.5","高雄市"
"2642","大樹區","18","370","13463","43100","22149","20951","105.5","高雄市"
"2643","大社區","9","174","12740","34599","17595","17004","105.5","高雄市"
"2644","仁武區","16","388","31502","83146","42336","40810","105.5","高雄市"
"2645","鳥松區","7","191","17845","44024","22405","21619","105.5","高雄市"
"2646","岡山區","33","530","34709","97782","48609","49173","105.5","高雄市"
"2647","橋頭區","17","347","13299","37333","19014","18319","105.5","高雄市"
"2648","燕巢區","11","278","10413","30001","15888","14113","105.5","高雄市"
"2649","田寮區","10","140","3341","7397","4110","3287","105.5","高雄市"
"2650","阿蓮區","12","275","9385","29227","14750","14477","105.5","高雄市"
"2651","路竹區","20","392","16879","53072","27099","25973","105.5","高雄市"
"2652","湖內區","14","255","10622","29656","15137","14519","105.5","高雄市"
"2653","茄萣區","15","304","10462","30423","15716","14707","105.5","高雄市"
"2654","永安區","6","81","5734","14077","7085","6992","105.5","高雄市"
"2655","彌陀區","12","206","6758","19627","10117","9510","105.5","高雄市"
"2656","梓官區","15","273","12567","36321","18749","17572","105.5","高雄市"
"2657","旗山區","21","377","13816","37586","19476","18110","105.5","高雄市"
"2658","美濃區","19","382","14606","40643","21307","19336","105.5","高雄市"
"2659","六龜區","12","215","5599","13356","7191","6165","105.5","高雄市"
"2660","甲仙區","7","91","2361","6244","3320","2924","105.5","高雄市"
"2661","杉林區","8","142","4805","12315","6731","5584","105.5","高雄市"
"2662","內門區","18","196","5085","14837","8042","6795","105.5","高雄市"
"2663","茂林區","3","19","581","1896","932","964","105.5","高雄市"
"2664","桃源區","8","39","1326","4217","2213","2004","105.5","高雄市"
"2665","那瑪夏區","3","20","853","3142","1623","1519","105.5","高雄市"
"2666","高雄市","891","17335","1076120","2778092","1379503","1398589","105.6","高雄市"
"2667","鹽埕區","21","228","10801","24829","12313","12516","105.6","高雄市"
"2668","鼓山區","38","719","56505","137110","66471","70639","105.6","高雄市"
"2669","左營區","39","710","77951","196713","94934","101779","105.6","高雄市"
"2670","楠梓區","37","803","68110","180893","89051","91842","105.6","高雄市"
"2671","三民一","41","651","32929","80835","39981","40854","105.6","高雄市"
"2672","三民二","45","1083","102407","264569","127544","137025","105.6","高雄市"
"2673","新興區","32","453","22649","51753","24949","26804","105.6","高雄市"
"2674","前金區","20","261","12475","27240","13079","14161","105.6","高雄市"
"2675","苓雅區","69","1240","72254","173803","83906","89897","105.6","高雄市"
"2676","前鎮區","59","1298","78322","191884","94506","97378","105.6","高雄市"
"2677","旗津區","13","212","11093","28902","14977","13925","105.6","高雄市"
"2678","小港區","38","697","66788","156396","77836","78560","105.6","高雄市"
"2679","鳳山一","41","1046","70543","179777","87705","92072","105.6","高雄市"
"2680","鳳山二","35","1007","67266","177263","87736","89527","105.6","高雄市"
"2681","林園區","24","517","25639","70261","35611","34650","105.6","高雄市"
"2682","大寮區","25","724","41549","111816","57405","54411","105.6","高雄市"
"2683","大樹區","18","370","13466","43095","22146","20949","105.6","高雄市"
"2684","大社區","9","174","12751","34610","17581","17029","105.6","高雄市"
"2685","仁武區","16","388","31561","83262","42379","40883","105.6","高雄市"
"2686","鳥松區","7","191","17863","44068","22423","21645","105.6","高雄市"
"2687","岡山區","33","530","34706","97787","48593","49194","105.6","高雄市"
"2688","橋頭區","17","347","13313","37332","19009","18323","105.6","高雄市"
"2689","燕巢區","11","278","10416","30019","15894","14125","105.6","高雄市"
"2690","田寮區","10","140","3336","7395","4102","3293","105.6","高雄市"
"2691","阿蓮區","12","275","9381","29201","14734","14467","105.6","高雄市"
"2692","路竹區","20","392","16884","53069","27095","25974","105.6","高雄市"
"2693","湖內區","14","255","10637","29664","15128","14536","105.6","高雄市"
"2694","茄萣區","15","304","10463","30419","15692","14727","105.6","高雄市"
"2695","永安區","6","81","5729","14053","7073","6980","105.6","高雄市"
"2696","彌陀區","12","206","6764","19640","10128","9512","105.6","高雄市"
"2697","梓官區","15","273","12565","36251","18724","17527","105.6","高雄市"
"2698","旗山區","21","378","13805","37574","19461","18113","105.6","高雄市"
"2699","美濃區","19","382","14603","40614","21292","19322","105.6","高雄市"
"2700","六龜區","12","215","5594","13346","7182","6164","105.6","高雄市"
"2701","甲仙區","7","91","2362","6242","3322","2920","105.6","高雄市"
"2702","杉林區","8","142","4798","12310","6731","5579","105.6","高雄市"
"2703","內門區","18","196","5083","14832","8038","6794","105.6","高雄市"
"2704","茂林區","3","19","582","1899","933","966","105.6","高雄市"
"2705","桃源區","8","39","1325","4224","2216","2008","105.6","高雄市"
"2706","那瑪夏區","3","20","852","3142","1623","1519","105.6","高雄市"
"2707","高雄市","891","17332","1077111","2778285","1379513","1398772","105.7","高雄市"
"2708","鹽埕區","21","228","10797","24771","12295","12476","105.7","高雄市"
"2709","鼓山區","38","719","56620","137314","66555","70759","105.7","高雄市"
"2710","左營區","39","708","78000","196744","94916","101828","105.7","高雄市"
"2711","楠梓區","37","803","68270","181072","89157","91915","105.7","高雄市"
"2712","三民一","41","651","32923","80701","39913","40788","105.7","高雄市"
"2713","三民二","45","1083","102510","264550","127548","137002","105.7","高雄市"
"2714","新興區","32","453","22677","51707","24922","26785","105.7","高雄市"
"2715","前金區","20","261","12489","27196","13055","14141","105.7","高雄市"
"2716","苓雅區","69","1240","72212","173605","83838","89767","105.7","高雄市"
"2717","前鎮區","59","1298","78347","191701","94381","97320","105.7","高雄市"
"2718","旗津區","13","212","11095","28939","14972","13967","105.7","高雄市"
"2719","小港區","38","697","66854","156481","77880","78601","105.7","高雄市"
"2720","鳳山一","41","1046","70619","179839","87736","92103","105.7","高雄市"
"2721","鳳山二","35","1007","67383","177477","87824","89653","105.7","高雄市"
"2722","林園區","24","517","25653","70254","35622","34632","105.7","高雄市"
"2723","大寮區","25","724","41608","111918","57446","54472","105.7","高雄市"
"2724","大樹區","18","370","13470","43052","22115","20937","105.7","高雄市"
"2725","大社區","9","174","12755","34609","17570","17039","105.7","高雄市"
"2726","仁武區","16","388","31645","83452","42468","40984","105.7","高雄市"
"2727","鳥松區","7","191","17886","44065","22427","21638","105.7","高雄市"
"2728","岡山區","33","530","34732","97752","48551","49201","105.7","高雄市"
"2729","橋頭區","17","347","13335","37366","19022","18344","105.7","高雄市"
"2730","燕巢區","11","278","10435","30018","15899","14119","105.7","高雄市"
"2731","田寮區","10","140","3331","7390","4102","3288","105.7","高雄市"
"2732","阿蓮區","12","275","9378","29171","14722","14449","105.7","高雄市"
"2733","路竹區","20","392","16901","53088","27114","25974","105.7","高雄市"
"2734","湖內區","14","255","10652","29665","15123","14542","105.7","高雄市"
"2735","茄萣區","15","304","10466","30426","15696","14730","105.7","高雄市"
"2736","永安區","6","81","5728","14051","7072","6979","105.7","高雄市"
"2737","彌陀區","12","206","6777","19653","10132","9521","105.7","高雄市"
"2738","梓官區","15","273","12561","36251","18716","17535","105.7","高雄市"
"2739","旗山區","21","377","13804","37515","19437","18078","105.7","高雄市"
"2740","美濃區","19","382","14613","40574","21281","19293","105.7","高雄市"
"2741","六龜區","12","215","5579","13310","7164","6146","105.7","高雄市"
"2742","甲仙區","7","91","2357","6226","3315","2911","105.7","高雄市"
"2743","杉林區","8","142","4806","12305","6729","5576","105.7","高雄市"
"2744","內門區","18","196","5084","14826","8034","6792","105.7","高雄市"
"2745","茂林區","3","19","582","1903","935","968","105.7","高雄市"
"2746","桃源區","8","39","1324","4210","2208","2002","105.7","高雄市"
"2747","那瑪夏區","3","20","853","3138","1621","1517","105.7","高雄市"
"2748","高雄市","891","17334","1078635","2778318","1379378","1398940","105.8","高雄市"
"2749","鹽埕區","21","228","10797","24728","12271","12457","105.8","高雄市"
"2750","鼓山區","38","719","56825","137557","66661","70896","105.8","高雄市"
"2751","左營區","39","710","78118","196828","94939","101889","105.8","高雄市"
"2752","楠梓區","37","803","68473","181202","89241","91961","105.8","高雄市"
"2753","三民一","41","651","32924","80554","39833","40721","105.8","高雄市"
"2754","三民二","45","1083","102651","264460","127498","136962","105.8","高雄市"
"2755","新興區","32","453","22672","51562","24836","26726","105.8","高雄市"
"2756","前金區","20","261","12504","27163","13048","14115","105.8","高雄市"
"2757","苓雅區","69","1240","72236","173437","83743","89694","105.8","高雄市"
"2758","前鎮區","59","1298","78420","191627","94312","97315","105.8","高雄市"
"2759","旗津區","13","212","11098","28925","14952","13973","105.8","高雄市"
"2760","小港區","38","697","66943","156502","77884","78618","105.8","高雄市"
"2761","鳳山一","41","1046","70686","179792","87715","92077","105.8","高雄市"
"2762","鳳山二","35","1007","67487","177606","87911","89695","105.8","高雄市"
"2763","林園區","24","517","25681","70274","35651","34623","105.8","高雄市"
"2764","大寮區","25","724","41675","111947","57452","54495","105.8","高雄市"
"2765","大樹區","18","370","13496","43073","22119","20954","105.8","高雄市"
"2766","大社區","9","174","12791","34621","17568","17053","105.8","高雄市"
"2767","仁武區","16","388","31776","83714","42586","41128","105.8","高雄市"
"2768","鳥松區","7","191","17944","44142","22470","21672","105.8","高雄市"
"2769","岡山區","33","530","34787","97687","48514","49173","105.8","高雄市"
"2770","橋頭區","17","347","13372","37411","19029","18382","105.8","高雄市"
"2771","燕巢區","11","278","10435","30009","15886","14123","105.8","高雄市"
"2772","田寮區","10","140","3331","7381","4096","3285","105.8","高雄市"
"2773","阿蓮區","12","275","9381","29154","14713","14441","105.8","高雄市"
"2774","路竹區","20","392","16905","53068","27101","25967","105.8","高雄市"
"2775","湖內區","14","255","10677","29714","15135","14579","105.8","高雄市"
"2776","茄萣區","15","304","10476","30433","15701","14732","105.8","高雄市"
"2777","永安區","6","81","5731","14045","7071","6974","105.8","高雄市"
"2778","彌陀區","12","206","6772","19632","10116","9516","105.8","高雄市"
"2779","梓官區","15","273","12556","36250","18709","17541","105.8","高雄市"
"2780","旗山區","21","377","13816","37466","19406","18060","105.8","高雄市"
"2781","美濃區","19","382","14632","40531","21258","19273","105.8","高雄市"
"2782","六龜區","12","215","5567","13278","7141","6137","105.8","高雄市"
"2783","甲仙區","7","91","2351","6207","3305","2902","105.8","高雄市"
"2784","杉林區","8","142","4808","12292","6728","5564","105.8","高雄市"
"2785","內門區","18","196","5082","14802","8019","6783","105.8","高雄市"
"2786","茂林區","3","19","582","1897","934","963","105.8","高雄市"
"2787","桃源區","8","39","1325","4214","2208","2006","105.8","高雄市"
"2788","那瑪夏區","3","20","852","3133","1618","1515","105.8","高雄市"
"2789","高雄市","891","17334","1080508","2778332","1379143","1399189","105.9","高雄市"
"2790","鹽埕區","21","228","10800","24680","12237","12443","105.9","高雄市"
"2791","鼓山區","38","719","57059","137710","66695","71015","105.9","高雄市"
"2792","左營區","39","710","78261","196765","94914","101851","105.9","高雄市"
"2793","楠梓區","37","803","68743","181426","89348","92078","105.9","高雄市"
"2794","三民一","41","651","32957","80482","39817","40665","105.9","高雄市"
"2795","三民二","45","1083","102841","264481","127472","137009","105.9","高雄市"
"2796","新興區","32","453","22709","51501","24794","26707","105.9","高雄市"
"2797","前金區","20","261","12513","27138","13037","14101","105.9","高雄市"
"2798","苓雅區","69","1240","72253","173184","83631","89553","105.9","高雄市"
"2799","前鎮區","59","1298","78486","191526","94239","97287","105.9","高雄市"
"2800","旗津區","13","212","11105","28924","14951","13973","105.9","高雄市"
"2801","小港區","38","697","67089","156626","77916","78710","105.9","高雄市"
"2802","鳳山一","41","1046","70795","179764","87633","92131","105.9","高雄市"
"2803","鳳山二","35","1007","67585","177740","87972","89768","105.9","高雄市"
"2804","林園區","24","517","25702","70219","35628","34591","105.9","高雄市"
"2805","大寮區","25","724","41738","112029","57472","54557","105.9","高雄市"
"2806","大樹區","18","370","13517","43082","22125","20957","105.9","高雄市"
"2807","大社區","9","174","12802","34609","17558","17051","105.9","高雄市"
"2808","仁武區","16","388","31909","83879","42654","41225","105.9","高雄市"
"2809","鳥松區","7","191","18014","44225","22516","21709","105.9","高雄市"
"2810","岡山區","33","530","34836","97608","48490","49118","105.9","高雄市"
"2811","橋頭區","17","347","13420","37432","19042","18390","105.9","高雄市"
"2812","燕巢區","11","278","10440","30006","15877","14129","105.9","高雄市"
"2813","田寮區","10","140","3324","7364","4083","3281","105.9","高雄市"
"2814","阿蓮區","12","275","9398","29145","14702","14443","105.9","高雄市"
"2815","路竹區","20","392","16912","53037","27075","25962","105.9","高雄市"
"2816","湖內區","14","255","10701","29737","15140","14597","105.9","高雄市"
"2817","茄萣區","15","304","10481","30447","15720","14727","105.9","高雄市"
"2818","永安區","6","81","5728","14032","7062","6970","105.9","高雄市"
"2819","彌陀區","12","206","6770","19600","10101","9499","105.9","高雄市"
"2820","梓官區","15","273","12572","36237","18700","17537","105.9","高雄市"
"2821","旗山區","21","377","13821","37444","19390","18054","105.9","高雄市"
"2822","美濃區","19","382","14649","40469","21229","19240","105.9","高雄市"
"2823","六龜區","12","215","5567","13266","7130","6136","105.9","高雄市"
"2824","甲仙區","7","91","2350","6225","3313","2912","105.9","高雄市"
"2825","杉林區","8","142","4812","12274","6717","5557","105.9","高雄市"
"2826","內門區","18","196","5091","14776","8002","6774","105.9","高雄市"
"2827","茂林區","3","19","582","1897","936","961","105.9","高雄市"
"2828","桃源區","8","39","1323","4218","2208","2010","105.9","高雄市"
"2829","那瑪夏區","3","20","853","3128","1617","1511","105.9","高雄市"
"2830","高雄市","891","17335","1080598","2778375","1378994","1399381","105.10","高雄市"
"2831","鹽埕區","21","228","10819","24688","12239","12449","105.10","高雄市"
"2832","鼓山區","38","719","57107","137864","66750","71114","105.10","高雄市"
"2833","左營區","39","710","78257","196813","94916","101897","105.10","高雄市"
"2834","楠梓區","37","803","68804","181541","89415","92126","105.10","高雄市"
"2835","三民一","41","651","32943","80444","39776","40668","105.10","高雄市"
"2836","三民二","45","1083","102815","264423","127413","137010","105.10","高雄市"
"2837","新興區","32","453","22688","51437","24764","26673","105.10","高雄市"
"2838","前金區","20","261","12516","27137","13020","14117","105.10","高雄市"
"2839","苓雅區","69","1240","72204","173117","83607","89510","105.10","高雄市"
"2840","前鎮區","59","1298","78433","191361","94144","97217","105.10","高雄市"
"2841","旗津區","13","212","11106","28941","14966","13975","105.10","高雄市"
"2842","小港區","38","697","67150","156738","77956","78782","105.10","高雄市"
"2843","鳳山一","41","1046","70795","179736","87612","92124","105.10","高雄市"
"2844","鳳山二","35","1007","67605","177734","87964","89770","105.10","高雄市"
"2845","林園區","24","517","25701","70220","35633","34587","105.10","高雄市"
"2846","大寮區","25","724","41776","112091","57500","54591","105.10","高雄市"
"2847","大樹區","18","370","13518","43090","22115","20975","105.10","高雄市"
"2848","大社區","9","174","12807","34599","17553","17046","105.10","高雄市"
"2849","仁武區","16","388","31960","83985","42701","41284","105.10","高雄市"
"2850","鳥松區","7","191","18016","44229","22514","21715","105.10","高雄市"
"2851","岡山區","33","530","34812","97570","48471","49099","105.10","高雄市"
"2852","橋頭區","17","347","13427","37450","19053","18397","105.10","高雄市"
"2853","燕巢區","11","278","10446","29991","15857","14134","105.10","高雄市"
"2854","田寮區","10","140","3315","7359","4078","3281","105.10","高雄市"
"2855","阿蓮區","12","275","9385","29125","14693","14432","105.10","高雄市"
"2856","路竹區","20","392","16902","53024","27079","25945","105.10","高雄市"
"2857","湖內區","14","256","10704","29772","15166","14606","105.10","高雄市"
"2858","茄萣區","15","304","10466","30422","15700","14722","105.10","高雄市"
"2859","永安區","6","81","5730","14033","7064","6969","105.10","高雄市"
"2860","彌陀區","12","206","6763","19565","10089","9476","105.10","高雄市"
"2861","梓官區","15","273","12580","36278","18718","17560","105.10","高雄市"
"2862","旗山區","21","377","13809","37407","19362","18045","105.10","高雄市"
"2863","美濃區","19","382","14661","40466","21225","19241","105.10","高雄市"
"2864","六龜區","12","215","5570","13240","7107","6133","105.10","高雄市"
"2865","甲仙區","7","91","2347","6215","3309","2906","105.10","高雄市"
"2866","杉林區","8","142","4808","12254","6709","5545","105.10","高雄市"
"2867","內門區","18","196","5090","14766","7995","6771","105.10","高雄市"
"2868","茂林區","3","19","584","1900","939","961","105.10","高雄市"
"2869","桃源區","8","39","1324","4218","2202","2016","105.10","高雄市"
"2870","那瑪夏區","3","20","855","3132","1620","1512","105.10","高雄市"
"2871","高雄市","891","17334","1082096","2778770","1378987","1399783","105.11","高雄市"
"2872","鹽埕區","21","228","10829","24663","12232","12431","105.11","高雄市"
"2873","鼓山區","38","719","57211","137974","66794","71180","105.11","高雄市"
"2874","左營區","39","710","78351","196835","94917","101918","105.11","高雄市"
"2875","楠梓區","37","803","68920","181632","89421","92211","105.11","高雄市"
"2876","三民一","41","651","33002","80401","39743","40658","105.11","高雄市"
"2877","三民二","45","1083","102981","264456","127395","137061","105.11","高雄市"
"2878","新興區","32","453","22718","51439","24763","26676","105.11","高雄市"
"2879","前金區","20","261","12549","27162","13036","14126","105.11","高雄市"
"2880","苓雅區","69","1240","72237","172995","83513","89482","105.11","高雄市"
"2881","前鎮區","59","1298","78532","191320","94120","97200","105.11","高雄市"
"2882","旗津區","13","212","11110","28936","14968","13968","105.11","高雄市"
"2883","小港區","38","697","67257","156910","78033","78877","105.11","高雄市"
"2884","鳳山一","41","1046","70923","179841","87618","92223","105.11","高雄市"
"2885","鳳山二","35","1007","67726","177812","87976","89836","105.11","高雄市"
"2886","林園區","24","517","25707","70188","35610","34578","105.11","高雄市"
"2887","大寮區","25","724","41855","112149","57538","54611","105.11","高雄市"
"2888","大樹區","18","370","13534","43101","22122","20979","105.11","高雄市"
"2889","大社區","9","174","12837","34618","17561","17057","105.11","高雄市"
"2890","仁武區","16","388","32049","84081","42759","41322","105.11","高雄市"
"2891","鳥松區","7","191","18065","44250","22521","21729","105.11","高雄市"
"2892","岡山區","33","530","34835","97549","48461","49088","105.11","高雄市"
"2893","橋頭區","17","347","13435","37455","19059","18396","105.11","高雄市"
"2894","燕巢區","11","278","10458","29975","15852","14123","105.11","高雄市"
"2895","田寮區","10","140","3309","7342","4074","3268","105.11","高雄市"
"2896","阿蓮區","12","275","9399","29110","14695","14415","105.11","高雄市"
"2897","路竹區","20","392","16918","52997","27062","25935","105.11","高雄市"
"2898","湖內區","14","255","10736","29848","15202","14646","105.11","高雄市"
"2899","茄萣區","15","304","10471","30411","15696","14715","105.11","高雄市"
"2900","永安區","6","81","5738","14043","7064","6979","105.11","高雄市"
"2901","彌陀區","12","206","6778","19568","10082","9486","105.11","高雄市"
"2902","梓官區","15","273","12588","36267","18691","17576","105.11","高雄市"
"2903","旗山區","21","377","13803","37351","19343","18008","105.11","高雄市"
"2904","美濃區","19","382","14670","40429","21212","19217","105.11","高雄市"
"2905","六龜區","12","215","5565","13234","7108","6126","105.11","高雄市"
"2906","甲仙區","7","91","2343","6214","3311","2903","105.11","高雄市"
"2907","杉林區","8","142","4801","12219","6688","5531","105.11","高雄市"
"2908","內門區","18","196","5095","14754","7986","6768","105.11","高雄市"
"2909","茂林區","3","19","584","1895","941","954","105.11","高雄市"
"2910","桃源區","8","39","1325","4214","2201","2013","105.11","高雄市"
"2911","那瑪夏區","3","20","852","3132","1619","1513","105.11","高雄市"
"2912","高雄市","891","17333","1083002","2779371","1379043","1400328","105.12","高雄市"
"2913","鹽埕區","21","228","10833","24659","12215","12444","105.12","高雄市"
"2914","鼓山區","38","719","57286","138099","66812","71287","105.12","高雄市"
"2915","左營區","39","710","78421","196936","94958","101978","105.12","高雄市"
"2916","楠梓區","37","803","69012","181845","89509","92336","105.12","高雄市"
"2917","三民一","41","651","32987","80270","39706","40564","105.12","高雄市"
"2918","三民二","45","1083","103069","264618","127445","137173","105.12","高雄市"
"2919","新興區","32","453","22715","51431","24755","26676","105.12","高雄市"
"2920","前金區","20","261","12554","27151","13023","14128","105.12","高雄市"
"2921","苓雅區","69","1240","72227","172895","83431","89464","105.12","高雄市"
"2922","前鎮區","59","1298","78566","191262","94083","97179","105.12","高雄市"
"2923","旗津區","13","212","11112","28898","14954","13944","105.12","高雄市"
"2924","小港區","38","697","67351","157023","78087","78936","105.12","高雄市"
"2925","鳳山一","41","1046","71020","179908","87653","92255","105.12","高雄市"
"2926","鳳山二","35","1007","67780","177860","87996","89864","105.12","高雄市"
"2927","林園區","24","517","25738","70201","35604","34597","105.12","高雄市"
"2928","大寮區","25","724","41897","112258","57577","54681","105.12","高雄市"
"2929","大樹區","18","370","13548","43067","22111","20956","105.12","高雄市"
"2930","大社區","9","174","12842","34615","17567","17048","105.12","高雄市"
"2931","仁武區","16","388","32122","84122","42763","41359","105.12","高雄市"
"2932","鳥松區","7","191","18091","44265","22505","21760","105.12","高雄市"
"2933","岡山區","33","529","34866","97643","48477","49166","105.12","高雄市"
"2934","橋頭區","17","347","13444","37448","19041","18407","105.12","高雄市"
"2935","燕巢區","11","278","10453","29960","15846","14114","105.12","高雄市"
"2936","田寮區","10","140","3307","7340","4065","3275","105.12","高雄市"
"2937","阿蓮區","12","275","9407","29093","14686","14407","105.12","高雄市"
"2938","路竹區","20","392","16946","53007","27066","25941","105.12","高雄市"
"2939","湖內區","14","255","10751","29876","15219","14657","105.12","高雄市"
"2940","茄萣區","15","304","10491","30412","15706","14706","105.12","高雄市"
"2941","永安區","6","81","5745","14039","7060","6979","105.12","高雄市"
"2942","彌陀區","12","206","6784","19555","10070","9485","105.12","高雄市"
"2943","梓官區","15","273","12594","36252","18675","17577","105.12","高雄市"
"2944","旗山區","21","377","13804","37342","19336","18006","105.12","高雄市"
"2945","美濃區","19","382","14667","40399","21202","19197","105.12","高雄市"
"2946","六龜區","12","215","5563","13217","7107","6110","105.12","高雄市"
"2947","甲仙區","7","91","2342","6214","3314","2900","105.12","高雄市"
"2948","杉林區","8","142","4806","12201","6679","5522","105.12","高雄市"
"2949","內門區","18","196","5101","14743","7982","6761","105.12","高雄市"
"2950","茂林區","3","19","585","1896","943","953","105.12","高雄市"
"2951","桃源區","8","39","1324","4220","2198","2022","105.12","高雄市"
"2952","那瑪夏區","3","20","851","3131","1617","1514","105.12","高雄市"
"2953","高雄市","891","17333","1083425","2779332","1378847","1400485","106.1","高雄市"
"2954","鹽埕區","21","228","10831","24638","12204","12434","106.1","高雄市"
"2955","鼓山區","38","719","57306","138122","66791","71331","106.1","高雄市"
"2956","左營區","39","710","78439","197008","94977","102031","106.1","高雄市"
"2957","楠梓區","37","803","69068","181936","89545","92391","106.1","高雄市"
"2958","三民一","41","651","32988","80238","39674","40564","106.1","高雄市"
"2959","三民二","45","1083","103106","264666","127444","137222","106.1","高雄市"
"2960","新興區","32","453","22666","51336","24714","26622","106.1","高雄市"
"2961","前金區","20","261","12559","27164","13029","14135","106.1","高雄市"
"2962","苓雅區","69","1240","72204","172768","83355","89413","106.1","高雄市"
"2963","前鎮區","59","1298","78590","191157","94034","97123","106.1","高雄市"
"2964","旗津區","13","212","11107","28867","14938","13929","106.1","高雄市"
"2965","小港區","38","697","67416","157072","78100","78972","106.1","高雄市"
"2966","鳳山一","41","1046","71105","180062","87725","92337","106.1","高雄市"
"2967","鳳山二","35","1007","67857","177924","88036","89888","106.1","高雄市"
"2968","林園區","24","517","25735","70163","35579","34584","106.1","高雄市"
"2969","大寮區","25","724","41891","112213","57531","54682","106.1","高雄市"
"2970","大樹區","18","370","13553","43021","22076","20945","106.1","高雄市"
"2971","大社區","9","174","12844","34584","17562","17022","106.1","高雄市"
"2972","仁武區","16","388","32193","84317","42859","41458","106.1","高雄市"
"2973","鳥松區","7","191","18107","44243","22484","21759","106.1","高雄市"
"2974","岡山區","33","529","34879","97669","48498","49171","106.1","高雄市"
"2975","橋頭區","17","347","13470","37457","19045","18412","106.1","高雄市"
"2976","燕巢區","11","278","10458","29970","15839","14131","106.1","高雄市"
"2977","田寮區","10","140","3303","7328","4059","3269","106.1","高雄市"
"2978","阿蓮區","12","275","9404","29064","14672","14392","106.1","高雄市"
"2979","路竹區","20","392","16951","52993","27066","25927","106.1","高雄市"
"2980","湖內區","14","255","10751","29872","15220","14652","106.1","高雄市"
"2981","茄萣區","15","304","10497","30378","15684","14694","106.1","高雄市"
"2982","永安區","6","81","5748","14031","7058","6973","106.1","高雄市"
"2983","彌陀區","12","206","6784","19527","10046","9481","106.1","高雄市"
"2984","梓官區","15","273","12593","36262","18687","17575","106.1","高雄市"
"2985","旗山區","21","377","13794","37297","19301","17996","106.1","高雄市"
"2986","美濃區","19","382","14664","40419","21206","19213","106.1","高雄市"
"2987","六龜區","12","215","5558","13197","7110","6087","106.1","高雄市"
"2988","甲仙區","7","91","2343","6209","3305","2904","106.1","高雄市"
"2989","杉林區","8","142","4795","12184","6664","5520","106.1","高雄市"
"2990","內門區","18","196","5105","14717","7970","6747","106.1","高雄市"
"2991","茂林區","3","19","587","1902","946","956","106.1","高雄市"
"2992","桃源區","8","39","1325","4223","2199","2024","106.1","高雄市"
"2993","那瑪夏區","3","20","851","3134","1615","1519","106.1","高雄市"
"2994","高雄市","891","17333","1083940","2779052","1378572","1400480","106.2","高雄市"
"2995","鹽埕區","21","228","10838","24618","12200","12418","106.2","高雄市"
"2996","鼓山區","38","719","57363","138214","66835","71379","106.2","高雄市"
"2997","左營區","39","710","78499","197034","94946","102088","106.2","高雄市"
"2998","楠梓區","37","803","69142","182104","89629","92475","106.2","高雄市"
"2999","三民一","41","651","32962","80119","39619","40500","106.2","高雄市"
"3000","三民二","45","1083","103187","264763","127526","137237","106.2","高雄市"
"3001","新興區","32","453","22660","51253","24666","26587","106.2","高雄市"
"3002","前金區","20","261","12544","27128","13008","14120","106.2","高雄市"
"3003","苓雅區","69","1240","72209","172613","83256","89357","106.2","高雄市"
"3004","前鎮區","59","1298","78594","191083","93987","97096","106.2","高雄市"
"3005","旗津區","13","212","11109","28855","14922","13933","106.2","高雄市"
"3006","小港區","38","697","67445","157100","78095","79005","106.2","高雄市"
"3007","鳳山一","41","1046","71155","180135","87744","92391","106.2","高雄市"
"3008","鳳山二","35","1007","67930","177919","88022","89897","106.2","高雄市"
"3009","林園區","24","517","25749","70160","35563","34597","106.2","高雄市"
"3010","大寮區","25","724","41898","112184","57506","54678","106.2","高雄市"
"3011","大樹區","18","370","13558","43009","22062","20947","106.2","高雄市"
"3012","大社區","9","174","12840","34530","17537","16993","106.2","高雄市"
"3013","仁武區","16","388","32240","84422","42923","41499","106.2","高雄市"
"3014","鳥松區","7","191","18115","44237","22491","21746","106.2","高雄市"
"3015","岡山區","33","529","34891","97689","48508","49181","106.2","高雄市"
"3016","橋頭區","17","347","13482","37494","19061","18433","106.2","高雄市"
"3017","燕巢區","11","278","10458","29925","15811","14114","106.2","高雄市"
"3018","田寮區","10","140","3301","7317","4058","3259","106.2","高雄市"
"3019","阿蓮區","12","275","9410","29045","14669","14376","106.2","高雄市"
"3020","路竹區","20","392","16974","52963","27043","25920","106.2","高雄市"
"3021","湖內區","14","255","10755","29866","15219","14647","106.2","高雄市"
"3022","茄萣區","15","304","10494","30363","15669","14694","106.2","高雄市"
"3023","永安區","6","81","5752","14006","7047","6959","106.2","高雄市"
"3024","彌陀區","12","206","6782","19512","10037","9475","106.2","高雄市"
"3025","梓官區","15","273","12586","36231","18659","17572","106.2","高雄市"
"3026","旗山區","21","377","13787","37263","19275","17988","106.2","高雄市"
"3027","美濃區","19","382","14670","40382","21192","19190","106.2","高雄市"
"3028","六龜區","12","215","5557","13202","7108","6094","106.2","高雄市"
"3029","甲仙區","7","91","2340","6193","3303","2890","106.2","高雄市"
"3030","杉林區","8","142","4795","12157","6650","5507","106.2","高雄市"
"3031","內門區","18","196","5104","14694","7959","6735","106.2","高雄市"
"3032","茂林區","3","19","588","1906","946","960","106.2","高雄市"
"3033","桃源區","8","39","1326","4240","2208","2032","106.2","高雄市"
"3034","那瑪夏區","3","20","851","3124","1613","1511","106.2","高雄市"
"3035","高雄市","891","17333","1084777","2778726","1378142","1400584","106.3","高雄市"
"3036","鹽埕區","21","228","10824","24571","12177","12394","106.3","高雄市"
"3037","鼓山區","38","719","57391","138284","66858","71426","106.3","高雄市"
"3038","左營區","39","710","78526","197037","94962","102075","106.3","高雄市"
"3039","楠梓區","37","803","69273","182363","89716","92647","106.3","高雄市"
"3040","三民一","41","651","32985","80037","39572","40465","106.3","高雄市"
"3041","三民二","45","1083","103340","264881","127551","137330","106.3","高雄市"
"3042","新興區","32","453","22658","51204","24656","26548","106.3","高雄市"
"3043","前金區","20","261","12576","27158","13008","14150","106.3","高雄市"
"3044","苓雅區","69","1240","72198","172458","83149","89309","106.3","高雄市"
"3045","前鎮區","59","1298","78626","190963","93904","97059","106.3","高雄市"
"3046","旗津區","13","212","11120","28814","14912","13902","106.3","高雄市"
"3047","小港區","38","697","67503","157146","78089","79057","106.3","高雄市"
"3048","鳳山一","41","1046","71226","180168","87752","92416","106.3","高雄市"
"3049","鳳山二","35","1007","67988","177953","88022","89931","106.3","高雄市"
"3050","林園區","24","517","25758","70131","35541","34590","106.3","高雄市"
"3051","大寮區","25","724","41964","112205","57514","54691","106.3","高雄市"
"3052","大樹區","18","370","13573","42989","22046","20943","106.3","高雄市"
"3053","大社區","9","174","12848","34531","17545","16986","106.3","高雄市"
"3054","仁武區","16","388","32291","84454","42922","41532","106.3","高雄市"
"3055","鳥松區","7","191","18132","44271","22471","21800","106.3","高雄市"
"3056","岡山區","33","529","34889","97585","48474","49111","106.3","高雄市"
"3057","橋頭區","17","347","13508","37520","19058","18462","106.3","高雄市"
"3058","燕巢區","11","278","10470","29903","15805","14098","106.3","高雄市"
"3059","田寮區","10","140","3298","7294","4036","3258","106.3","高雄市"
"3060","阿蓮區","12","275","9422","29042","14669","14373","106.3","高雄市"
"3061","路竹區","20","392","17000","52965","27039","25926","106.3","高雄市"
"3062","湖內區","14","255","10741","29797","15190","14607","106.3","高雄市"
"3063","茄萣區","15","304","10489","30317","15643","14674","106.3","高雄市"
"3064","永安區","6","81","5750","13973","7027","6946","106.3","高雄市"
"3065","彌陀區","12","206","6788","19506","10038","9468","106.3","高雄市"
"3066","梓官區","15","273","12594","36187","18624","17563","106.3","高雄市"
"3067","旗山區","21","377","13783","37247","19276","17971","106.3","高雄市"
"3068","美濃區","19","382","14671","40335","21161","19174","106.3","高雄市"
"3069","六龜區","12","215","5568","13179","7088","6091","106.3","高雄市"
"3070","甲仙區","7","91","2342","6173","3293","2880","106.3","高雄市"
"3071","杉林區","8","142","4793","12156","6644","5512","106.3","高雄市"
"3072","內門區","18","196","5107","14673","7945","6728","106.3","高雄市"
"3073","茂林區","3","19","588","1906","947","959","106.3","高雄市"
"3074","桃源區","8","39","1324","4229","2208","2021","106.3","高雄市"
"3075","那瑪夏區","3","20","852","3121","1610","1511","106.3","高雄市"
"3076","高雄市","891","17332","1085256","2778734","1377883","1400851","106.4","高雄市"
"3077","鹽埕區","21","228","10810","24528","12147","12381","106.4","高雄市"
"3078","鼓山區","38","719","57444","138394","66900","71494","106.4","高雄市"
"3079","左營區","39","710","78541","197101","94952","102149","106.4","高雄市"
"3080","楠梓區","37","803","69327","182413","89726","92687","106.4","高雄市"
"3081","三民一","41","650","32987","79972","39520","40452","106.4","高雄市"
"3082","三民二","45","1083","103420","265043","127560","137483","106.4","高雄市"
"3083","新興區","32","453","22659","51197","24641","26556","106.4","高雄市"
"3084","前金區","20","261","12593","27181","13034","14147","106.4","高雄市"
"3085","苓雅區","69","1240","72172","172309","83072","89237","106.4","高雄市"
"3086","前鎮區","59","1298","78635","190865","93865","97000","106.4","高雄市"
"3087","旗津區","13","212","11117","28807","14903","13904","106.4","高雄市"
"3088","小港區","38","697","67565","157188","78094","79094","106.4","高雄市"
"3089","鳳山一","41","1046","71279","180205","87759","92446","106.4","高雄市"
"3090","鳳山二","35","1007","68032","177928","87998","89930","106.4","高雄市"
"3091","林園區","24","517","25756","70082","35513","34569","106.4","高雄市"
"3092","大寮區","25","724","41985","112286","57527","54759","106.4","高雄市"
"3093","大樹區","18","370","13574","42936","22023","20913","106.4","高雄市"
"3094","大社區","9","174","12861","34528","17538","16990","106.4","高雄市"
"3095","仁武區","16","388","32333","84514","42950","41564","106.4","高雄市"
"3096","鳥松區","7","191","18140","44270","22466","21804","106.4","高雄市"
"3097","岡山區","33","529","34903","97592","48482","49110","106.4","高雄市"
"3098","橋頭區","17","347","13518","37536","19065","18471","106.4","高雄市"
"3099","燕巢區","11","278","10468","29878","15780","14098","106.4","高雄市"
"3100","田寮區","10","140","3293","7286","4032","3254","106.4","高雄市"
"3101","阿蓮區","12","275","9421","29017","14654","14363","106.4","高雄市"
"3102","路竹區","20","392","17006","52928","27021","25907","106.4","高雄市"
"3103","湖內區","14","255","10743","29788","15193","14595","106.4","高雄市"
"3104","茄萣區","15","304","10497","30335","15651","14684","106.4","高雄市"
"3105","永安區","6","81","5748","13986","7039","6947","106.4","高雄市"
"3106","彌陀區","12","206","6783","19502","10029","9473","106.4","高雄市"
"3107","梓官區","15","273","12608","36191","18620","17571","106.4","高雄市"
"3108","旗山區","21","377","13783","37248","19273","17975","106.4","高雄市"
"3109","美濃區","19","382","14686","40336","21157","19179","106.4","高雄市"
"3110","六龜區","12","215","5567","13164","7079","6085","106.4","高雄市"
"3111","甲仙區","7","91","2339","6166","3292","2874","106.4","高雄市"
"3112","杉林區","8","142","4795","12144","6633","5511","106.4","高雄市"
"3113","內門區","18","196","5107","14647","7937","6710","106.4","高雄市"
"3114","茂林區","3","19","587","1906","948","958","106.4","高雄市"
"3115","桃源區","8","39","1325","4234","2208","2026","106.4","高雄市"
"3116","那瑪夏區","3","20","849","3103","1602","1501","106.4","高雄市"
"3117","高雄市","891","17332","1086107","2778415","1377619","1400796","106.5","高雄市"
"3118","鹽埕區","21","228","10806","24503","12138","12365","106.5","高雄市"
"3119","鼓山區","38","719","57491","138441","66932","71509","106.5","高雄市"
"3120","左營區","39","710","78608","197171","94972","102199","106.5","高雄市"
"3121","楠梓區","37","803","69444","182596","89829","92767","106.5","高雄市"
"3122","三民一","41","650","33015","79915","39472","40443","106.5","高雄市"
"3123","三民二","45","1083","103478","264915","127507","137408","106.5","高雄市"
"3124","新興區","32","453","22671","51171","24620","26551","106.5","高雄市"
"3125","前金區","20","261","12600","27173","13008","14165","106.5","高雄市"
"3126","苓雅區","69","1240","72167","172125","82988","89137","106.5","高雄市"
"3127","前鎮區","59","1298","78623","190672","93742","96930","106.5","高雄市"
"3128","旗津區","13","212","11123","28807","14897","13910","106.5","高雄市"
"3129","小港區","38","697","67662","157259","78151","79108","106.5","高雄市"
"3130","鳳山一","41","1046","71401","180227","87759","92468","106.5","高雄市"
"3131","鳳山二","35","1007","68134","178021","88041","89980","106.5","高雄市"
"3132","林園區","24","517","25786","70073","35487","34586","106.5","高雄市"
"3133","大寮區","25","724","41992","112249","57527","54722","106.5","高雄市"
"3134","大樹區","18","370","13564","42885","21993","20892","106.5","高雄市"
"3135","大社區","9","174","12876","34496","17539","16957","106.5","高雄市"
"3136","仁武區","16","388","32424","84691","43018","41673","106.5","高雄市"
"3137","鳥松區","7","191","18186","44330","22497","21833","106.5","高雄市"
"3138","岡山區","33","529","34880","97536","48452","49084","106.5","高雄市"
"3139","橋頭區","17","347","13531","37529","19045","18484","106.5","高雄市"
"3140","燕巢區","11","278","10470","29876","15777","14099","106.5","高雄市"
"3141","田寮區","10","140","3293","7275","4027","3248","106.5","高雄市"
"3142","阿蓮區","12","275","9412","28996","14644","14352","106.5","高雄市"
"3143","路竹區","20","392","17020","52900","27005","25895","106.5","高雄市"
"3144","湖內區","14","255","10775","29813","15218","14595","106.5","高雄市"
"3145","茄萣區","15","304","10501","30337","15655","14682","106.5","高雄市"
"3146","永安區","6","81","5752","13979","7026","6953","106.5","高雄市"
"3147","彌陀區","12","206","6788","19476","10022","9454","106.5","高雄市"
"3148","梓官區","15","273","12620","36186","18616","17570","106.5","高雄市"
"3149","旗山區","21","377","13772","37214","19250","17964","106.5","高雄市"
"3150","美濃區","19","382","14689","40279","21118","19161","106.5","高雄市"
"3151","六龜區","12","215","5557","13135","7059","6076","106.5","高雄市"
"3152","甲仙區","7","91","2335","6151","3279","2872","106.5","高雄市"
"3153","杉林區","8","142","4794","12134","6621","5513","106.5","高雄市"
"3154","內門區","18","196","5103","14632","7926","6706","106.5","高雄市"
"3155","茂林區","3","19","587","1909","948","961","106.5","高雄市"
"3156","桃源區","8","39","1327","4235","2213","2022","106.5","高雄市"
"3157","那瑪夏區","3","20","850","3103","1601","1502","106.5","高雄市"
