"","區域名","里數","鄰數","戶數","人口數","男","女","年月","地區"
"1"," 嘉義縣","357","5266","155269","562305","296936","265369","89.12","嘉義縣"
"2"," 太保市","18","233","8330","32854","17234","15620","89.12","嘉義縣"
"3"," 朴子市","27","396","12088","44107","22860","21247","89.12","嘉義縣"
"4"," 布袋鎮","23","371","9355","33351","17487","15864","89.12","嘉義縣"
"5"," 大林鎮","21","317","10552","36205","18845","17360","89.12","嘉義縣"
"6"," 民雄鄉","28","489","19057","70625","36599","34026","89.12","嘉義縣"
"7"," 溪口鄉","14","205","4946","17929","9576","8353","89.12","嘉義縣"
"8"," 新港鄉","23","380","9479","36221","19369","16852","89.12","嘉義縣"
"9"," 六腳鄉","25","328","8422","29152","15577","13575","89.12","嘉義縣"
"10"," 東石鄉","23","351","8488","29957","16098","13859","89.12","嘉義縣"
"11"," 義竹鄉","22","311","6986","23306","12223","11083","89.12","嘉義縣"
"12"," 鹿草鄉","15","255","5323","18260","9837","8423","89.12","嘉義縣"
"13"," 水上鄉","26","409","16238","55395","29166","26229","89.12","嘉義縣"
"14"," 中埔鄉","22","375","13008","48435","25474","22961","89.12","嘉義縣"
"15"," 竹崎鄉","24","407","10312","41288","22098","19190","89.12","嘉義縣"
"16"," 梅山鄉","18","200","5829","23433","12545","10888","89.12","嘉義縣"
"17"," 番路鄉","11","112","3531","12085","6610","5475","89.12","嘉義縣"
"18"," 大埔鄉","5","49","1434","3547","1982","1565","89.12","嘉義縣"
"19"," 阿里山鄉","12","78","1891","6155","3356","2799","89.12","嘉義縣"
"20"," 嘉義縣","357","5285","157448","563365","297069","266296","90.12","嘉義縣"
"21"," 太保市","18","240","8638","33302","17470","15832","90.12","嘉義縣"
"22"," 朴子市","27","402","12295","44296","22877","21419","90.12","嘉義縣"
"23"," 布袋鎮","23","375","9484","33414","17487","15927","90.12","嘉義縣"
"24"," 大林鎮","21","317","10650","36144","18809","17335","90.12","嘉義縣"
"25"," 民雄鄉","28","489","19383","71034","36780","34254","90.12","嘉義縣"
"26"," 溪口鄉","14","205","4959","17782","9477","8305","90.12","嘉義縣"
"27"," 新港鄉","23","380","9505","36065","19203","16862","90.12","嘉義縣"
"28"," 六腳鄉","25","328","8523","28879","15441","13438","90.12","嘉義縣"
"29"," 東石鄉","23","353","8573","30118","16114","14004","90.12","嘉義縣"
"30"," 義竹鄉","22","311","7139","23827","12431","11396","90.12","嘉義縣"
"31"," 鹿草鄉","15","255","5357","18159","9801","8358","90.12","嘉義縣"
"32"," 水上鄉","26","409","16426","55411","29152","26259","90.12","嘉義縣"
"33"," 中埔鄉","22","375","13153","48301","25397","22904","90.12","嘉義縣"
"34"," 竹崎鄉","24","407","10443","41189","22042","19147","90.12","嘉義縣"
"35"," 梅山鄉","18","200","5925","23453","12519","10934","90.12","嘉義縣"
"36"," 番路鄉","11","112","3582","12054","6612","5442","90.12","嘉義縣"
"37"," 大埔鄉","5","49","1516","3815","2119","1696","90.12","嘉義縣"
"38"," 阿里山鄉","12","78","1897","6122","3338","2784","90.12","嘉義縣"
"39"," 嘉義縣","357","5293","158808","562394","296380","266014","91.12","嘉義縣"
"40"," 太保市","18","240","8917","33732","17694","16038","91.12","嘉義縣"
"41"," 朴子市","27","402","12406","44158","22808","21350","91.12","嘉義縣"
"42"," 布袋鎮","23","376","9559","33160","17320","15840","91.12","嘉義縣"
"43"," 大林鎮","21","317","10722","35985","18730","17255","91.12","嘉義縣"
"44"," 民雄鄉","28","496","19778","71605","37070","34535","91.12","嘉義縣"
"45"," 溪口鄉","14","205","4944","17652","9427","8225","91.12","嘉義縣"
"46"," 新港鄉","23","380","9544","36110","19230","16880","91.12","嘉義縣"
"47"," 六腳鄉","25","328","8563","28582","15258","13324","91.12","嘉義縣"
"48"," 東石鄉","23","353","8547","29855","15978","13877","91.12","嘉義縣"
"49"," 義竹鄉","22","311","7010","22934","11997","10937","91.12","嘉義縣"
"50"," 鹿草鄉","15","255","5313","18052","9694","8358","91.12","嘉義縣"
"51"," 水上鄉","26","409","16673","55724","29154","26570","91.12","嘉義縣"
"52"," 中埔鄉","22","375","13336","48452","25511","22941","91.12","嘉義縣"
"53"," 竹崎鄉","24","407","10577","41210","22041","19169","91.12","嘉義縣"
"54"," 梅山鄉","18","200","5973","23249","12414","10835","91.12","嘉義縣"
"55"," 番路鄉","11","112","3593","12095","6640","5455","91.12","嘉義縣"
"56"," 大埔鄉","5","49","1450","3644","2039","1605","91.12","嘉義縣"
"57"," 阿里山鄉","12","78","1903","6195","3375","2820","91.12","嘉義縣"
"58"," 嘉義縣","357","5299","160342","560410","295343","265067","92.12","嘉義縣"
"59"," 太保市","18","245","9220","34330","18005","16325","92.12","嘉義縣"
"60"," 朴子市","27","402","12595","44166","22763","21403","92.12","嘉義縣"
"61"," 布袋鎮","23","375","9616","32770","17154","15616","92.12","嘉義縣"
"62"," 大林鎮","21","317","10672","35648","18536","17112","92.12","嘉義縣"
"63"," 民雄鄉","28","498","20152","71857","37242","34615","92.12","嘉義縣"
"64"," 溪口鄉","14","205","4978","17490","9361","8129","92.12","嘉義縣"
"65"," 新港鄉","23","380","9620","35969","19163","16806","92.12","嘉義縣"
"66"," 六腳鄉","25","328","8616","28293","15089","13204","92.12","嘉義縣"
"67"," 東石鄉","23","353","8596","29718","15916","13802","92.12","嘉義縣"
"68"," 義竹鄉","22","311","7026","22667","11855","10812","92.12","嘉義縣"
"69"," 鹿草鄉","15","255","5338","17827","9580","8247","92.12","嘉義縣"
"70"," 水上鄉","26","409","16825","55483","29026","26457","92.12","嘉義縣"
"71"," 中埔鄉","22","375","13524","48340","25429","22911","92.12","嘉義縣"
"72"," 竹崎鄉","24","407","10608","40916","21905","19011","92.12","嘉義縣"
"73"," 梅山鄉","18","200","5998","23128","12322","10806","92.12","嘉義縣"
"74"," 番路鄉","11","112","3610","12037","6605","5432","92.12","嘉義縣"
"75"," 大埔鄉","5","49","1420","3542","2010","1532","92.12","嘉義縣"
"76"," 阿里山鄉","12","78","1928","6229","3382","2847","92.12","嘉義縣"
"77"," 嘉義縣","357","5300","162699","557903","293894","264009","93.12","嘉義縣"
"78"," 太保市","18","245","9511","34597","18124","16473","93.12","嘉義縣"
"79"," 朴子市","27","403","12779","44057","22690","21367","93.12","嘉義縣"
"80"," 布袋鎮","23","375","9696","32480","16975","15505","93.12","嘉義縣"
"81"," 大林鎮","21","317","10777","35309","18380","16929","93.12","嘉義縣"
"82"," 民雄鄉","28","498","20651","72451","37494","34957","93.12","嘉義縣"
"83"," 溪口鄉","14","205","5073","17273","9246","8027","93.12","嘉義縣"
"84"," 新港鄉","23","380","9778","35815","19041","16774","93.12","嘉義縣"
"85"," 六腳鄉","25","328","8687","27939","14898","13041","93.12","嘉義縣"
"86"," 東石鄉","23","353","8709","29399","15740","13659","93.12","嘉義縣"
"87"," 義竹鄉","22","311","7034","22303","11669","10634","93.12","嘉義縣"
"88"," 鹿草鄉","15","255","5408","17727","9550","8177","93.12","嘉義縣"
"89"," 水上鄉","26","409","17045","55276","28905","26371","93.12","嘉義縣"
"90"," 中埔鄉","22","375","13731","48157","25368","22789","93.12","嘉義縣"
"91"," 竹崎鄉","24","407","10769","40576","21720","18856","93.12","嘉義縣"
"92"," 梅山鄉","18","200","6051","22874","12188","10686","93.12","嘉義縣"
"93"," 番路鄉","11","112","3633","11958","6542","5416","93.12","嘉義縣"
"94"," 大埔鄉","5","49","1430","3524","2000","1524","93.12","嘉義縣"
"95"," 阿里山鄉","12","78","1937","6188","3364","2824","93.12","嘉義縣"
"96"," 嘉義縣","357","5304","164911","557101","292919","264182","94.12","嘉義縣"
"97"," 太保市","18","245","9771","35066","18293","16773","94.12","嘉義縣"
"98"," 朴子市","27","403","13218","44463","22867","21596","94.12","嘉義縣"
"99"," 布袋鎮","23","375","9815","32274","16798","15476","94.12","嘉義縣"
"100"," 大林鎮","21","317","10774","34938","18139","16799","94.12","嘉義縣"
"101"," 民雄鄉","28","498","20984","72556","37478","35078","94.12","嘉義縣"
"102"," 溪口鄉","14","205","5126","17371","9262","8109","94.12","嘉義縣"
"103"," 新港鄉","23","380","9876","35724","18969","16755","94.12","嘉義縣"
"104"," 六腳鄉","25","328","8764","27787","14793","12994","94.12","嘉義縣"
"105"," 東石鄉","23","357","8952","29374","15694","13680","94.12","嘉義縣"
"106"," 義竹鄉","22","311","7119","22407","11686","10721","94.12","嘉義縣"
"107"," 鹿草鄉","15","255","5454","17661","9521","8140","94.12","嘉義縣"
"108"," 水上鄉","26","409","16936","54533","28524","26009","94.12","嘉義縣"
"109"," 中埔鄉","22","375","13959","48069","25298","22771","94.12","嘉義縣"
"110"," 竹崎鄉","24","407","10876","40130","21487","18643","94.12","嘉義縣"
"111"," 梅山鄉","18","200","6166","22778","12110","10668","94.12","嘉義縣"
"112"," 番路鄉","11","112","3673","12051","6575","5476","94.12","嘉義縣"
"113"," 大埔鄉","5","49","1509","3733","2076","1657","94.12","嘉義縣"
"114"," 阿里山鄉","12","78","1939","6186","3349","2837","94.12","嘉義縣"
"115"," 嘉義縣","357","5311","166879","553841","290855","262986","95.12","嘉義縣"
"116"," 太保市","18","245","10060","35180","18340","16840","95.12","嘉義縣"
"117"," 朴子市","27","403","13401","44329","22794","21535","95.12","嘉義縣"
"118"," 布袋鎮","23","375","9809","31667","16452","15215","95.12","嘉義縣"
"119"," 大林鎮","21","317","10814","34666","17934","16732","95.12","嘉義縣"
"120"," 民雄鄉","28","505","21278","72836","37668","35168","95.12","嘉義縣"
"121"," 溪口鄉","14","205","5159","17051","9110","7941","95.12","嘉義縣"
"122"," 新港鄉","23","380","9970","35488","18797","16691","95.12","嘉義縣"
"123"," 六腳鄉","25","328","8849","27645","14696","12949","95.12","嘉義縣"
"124"," 東石鄉","23","357","9023","28978","15488","13490","95.12","嘉義縣"
"125"," 義竹鄉","22","311","7166","22020","11489","10531","95.12","嘉義縣"
"126"," 鹿草鄉","15","255","5488","17529","9418","8111","95.12","嘉義縣"
"127"," 水上鄉","26","409","17026","54061","28231","25830","95.12","嘉義縣"
"128"," 中埔鄉","22","375","14263","48219","25300","22919","95.12","嘉義縣"
"129"," 竹崎鄉","24","407","10977","39721","21210","18511","95.12","嘉義縣"
"130"," 梅山鄉","18","200","6251","22515","11984","10531","95.12","嘉義縣"
"131"," 番路鄉","11","112","3694","11885","6504","5381","95.12","嘉義縣"
"132"," 大埔鄉","5","49","1728","3900","2126","1774","95.12","嘉義縣"
"133"," 阿里山鄉","12","78","1923","6151","3314","2837","95.12","嘉義縣"
"134"," 嘉義縣","357","5319","168916","551345","289202","262143","96.12","嘉義縣"
"135"," 太保市","18","250","10413","35669","18560","17109","96.12","嘉義縣"
"136"," 朴子市","27","403","13568","44222","22748","21474","96.12","嘉義縣"
"137"," 布袋鎮","23","375","9899","31372","16248","15124","96.12","嘉義縣"
"138"," 大林鎮","21","317","10853","34382","17783","16599","96.12","嘉義縣"
"139"," 民雄鄉","28","508","21598","72762","37574","35188","96.12","嘉義縣"
"140"," 溪口鄉","14","205","5185","16812","8989","7823","96.12","嘉義縣"
"141"," 新港鄉","23","380","10048","35363","18680","16683","96.12","嘉義縣"
"142"," 六腳鄉","25","328","8911","27327","14520","12807","96.12","嘉義縣"
"143"," 東石鄉","23","357","9115","28761","15340","13421","96.12","嘉義縣"
"144"," 義竹鄉","22","311","7258","21880","11403","10477","96.12","嘉義縣"
"145"," 鹿草鄉","15","255","5528","17512","9397","8115","96.12","嘉義縣"
"146"," 水上鄉","26","409","17079","53498","27889","25609","96.12","嘉義縣"
"147"," 中埔鄉","22","375","14519","48039","25188","22851","96.12","嘉義縣"
"148"," 竹崎鄉","24","407","11034","39460","21087","18373","96.12","嘉義縣"
"149"," 梅山鄉","18","200","6314","22332","11862","10470","96.12","嘉義縣"
"150"," 番路鄉","11","112","3784","11778","6454","5324","96.12","嘉義縣"
"151"," 大埔鄉","5","49","1861","4011","2171","1840","96.12","嘉義縣"
"152"," 阿里山鄉","12","78","1949","6165","3309","2856","96.12","嘉義縣"
"153"," 嘉義縣","357","5319","171645","548731","287360","261371","97.12","嘉義縣"
"154"," 太保市","18","250","10691","35896","18641","17255","97.12","嘉義縣"
"155"," 朴子市","27","403","13924","44281","22698","21583","97.12","嘉義縣"
"156"," 布袋鎮","23","375","9988","30888","15955","14933","97.12","嘉義縣"
"157"," 大林鎮","21","317","10998","34101","17581","16520","97.12","嘉義縣"
"158"," 民雄鄉","28","508","21985","72641","37458","35183","97.12","嘉義縣"
"159"," 溪口鄉","14","205","5323","16695","8937","7758","97.12","嘉義縣"
"160"," 新港鄉","23","380","10174","35149","18555","16594","97.12","嘉義縣"
"161"," 六腳鄉","25","328","9053","27041","14358","12683","97.12","嘉義縣"
"162"," 東石鄉","23","357","9203","28399","15153","13246","97.12","嘉義縣"
"163"," 義竹鄉","22","311","7374","21671","11274","10397","97.12","嘉義縣"
"164"," 鹿草鄉","15","255","5623","17429","9359","8070","97.12","嘉義縣"
"165"," 水上鄉","26","409","17218","53130","27601","25529","97.12","嘉義縣"
"166"," 中埔鄉","22","375","14759","47840","25074","22766","97.12","嘉義縣"
"167"," 竹崎鄉","24","407","11127","39155","20900","18255","97.12","嘉義縣"
"168"," 梅山鄉","18","200","6468","22184","11787","10397","97.12","嘉義縣"
"169"," 番路鄉","11","112","3820","11619","6348","5271","97.12","嘉義縣"
"170"," 大埔鄉","5","49","1950","4434","2359","2075","97.12","嘉義縣"
"171"," 阿里山鄉","12","78","1967","6178","3322","2856","97.12","嘉義縣"
"172"," 嘉義縣","357","5328","174312","547716","286024","261692","98.12","嘉義縣"
"173"," 太保市","18","250","10987","36210","18724","17486","98.12","嘉義縣"
"174"," 朴子市","27","406","14289","44326","22640","21686","98.12","嘉義縣"
"175"," 布袋鎮","23","375","10132","30824","15844","14980","98.12","嘉義縣"
"176"," 大林鎮","21","317","11111","33982","17479","16503","98.12","嘉義縣"
"177"," 民雄鄉","28","514","22447","72793","37439","35354","98.12","嘉義縣"
"178"," 溪口鄉","14","205","5387","16563","8832","7731","98.12","嘉義縣"
"179"," 新港鄉","23","380","10293","34995","18471","16524","98.12","嘉義縣"
"180"," 六腳鄉","25","328","9122","26890","14246","12644","98.12","嘉義縣"
"181"," 東石鄉","23","357","9383","28224","15008","13216","98.12","嘉義縣"
"182"," 義竹鄉","22","311","7447","21617","11188","10429","98.12","嘉義縣"
"183"," 鹿草鄉","15","255","5693","17405","9335","8070","98.12","嘉義縣"
"184"," 水上鄉","26","409","17246","52562","27229","25333","98.12","嘉義縣"
"185"," 中埔鄉","22","375","15071","47790","24991","22799","98.12","嘉義縣"
"186"," 竹崎鄉","24","407","11233","38962","20763","18199","98.12","嘉義縣"
"187"," 梅山鄉","18","200","6590","22049","11695","10354","98.12","嘉義縣"
"188"," 番路鄉","11","112","3883","11730","6374","5356","98.12","嘉義縣"
"189"," 大埔鄉","5","49","1962","4572","2424","2148","98.12","嘉義縣"
"190"," 阿里山鄉","12","78","2036","6222","3342","2880","98.12","嘉義縣"
"191"," 嘉義縣","357","5336","176398","543248","283284","259964","99.12","嘉義縣"
"192"," 太保市","18","250","11303","36685","18919","17766","99.12","嘉義縣"
"193"," 朴子市","27","414","14635","44093","22505","21588","99.12","嘉義縣"
"194"," 布袋鎮","23","375","10144","30216","15487","14729","99.12","嘉義縣"
"195"," 大林鎮","21","317","11209","33635","17263","16372","99.12","嘉義縣"
"196"," 民雄鄉","28","514","22813","72539","37236","35303","99.12","嘉義縣"
"197"," 溪口鄉","14","205","5385","16269","8674","7595","99.12","嘉義縣"
"198"," 新港鄉","23","380","10402","34676","18297","16379","99.12","嘉義縣"
"199"," 六腳鄉","25","328","9155","26379","13974","12405","99.12","嘉義縣"
"200"," 東石鄉","23","357","9512","27741","14745","12996","99.12","嘉義縣"
"201"," 義竹鄉","22","311","7477","21129","10937","10192","99.12","嘉義縣"
"202"," 鹿草鄉","15","255","5733","17232","9265","7967","99.12","嘉義縣"
"203"," 水上鄉","26","409","17410","52274","27004","25270","99.12","嘉義縣"
"204"," 中埔鄉","22","375","15289","47579","24818","22761","99.12","嘉義縣"
"205"," 竹崎鄉","24","407","11309","38608","20544","18064","99.12","嘉義縣"
"206"," 梅山鄉","18","200","6646","21634","11463","10171","99.12","嘉義縣"
"207"," 番路鄉","11","112","3948","11684","6367","5317","99.12","嘉義縣"
"208"," 大埔鄉","5","49","1962","4649","2447","2202","99.12","嘉義縣"
"209"," 阿里山鄉","12","78","2066","6226","3339","2887","99.12","嘉義縣"
"210"," 嘉義縣","357","5345","177906","537942","280416","257526","100.12","嘉義縣"
"211"," 太保市","18","250","11545","36673","18893","17780","100.12","嘉義縣"
"212"," 朴子市","27","414","14857","43895","22343","21552","100.12","嘉義縣"
"213"," 布袋鎮","23","375","10156","29664","15207","14457","100.12","嘉義縣"
"214"," 大林鎮","21","317","11276","33207","17045","16162","100.12","嘉義縣"
"215"," 民雄鄉","28","522","23146","72451","37173","35278","100.12","嘉義縣"
"216"," 溪口鄉","14","205","5390","16015","8554","7461","100.12","嘉義縣"
"217"," 新港鄉","23","380","10437","34231","18057","16174","100.12","嘉義縣"
"218"," 六腳鄉","25","328","9144","25903","13731","12172","100.12","嘉義縣"
"219"," 東石鄉","23","357","9505","27202","14449","12753","100.12","嘉義縣"
"220"," 義竹鄉","22","311","7476","20653","10727","9926","100.12","嘉義縣"
"221"," 鹿草鄉","15","255","5801","17022","9156","7866","100.12","嘉義縣"
"222"," 水上鄉","26","409","17448","51793","26711","25082","100.12","嘉義縣"
"223"," 中埔鄉","22","375","15539","47291","24663","22628","100.12","嘉義縣"
"224"," 竹崎鄉","24","407","11441","38179","20344","17835","100.12","嘉義縣"
"225"," 梅山鄉","18","200","6675","21171","11203","9968","100.12","嘉義縣"
"226"," 番路鄉","11","113","4077","11881","6476","5405","100.12","嘉義縣"
"227"," 大埔鄉","5","49","1927","4554","2402","2152","100.12","嘉義縣"
"228"," 阿里山鄉","12","78","2066","6157","3282","2875","100.12","嘉義縣"
"229"," 嘉義縣","357","5347","179676","533723","278219","255504","101.12","嘉義縣"
"230"," 太保市","18","250","11775","36946","19039","17907","101.12","嘉義縣"
"231"," 朴子市","27","414","15123","43855","22274","21581","101.12","嘉義縣"
"232"," 布袋鎮","23","375","10194","29244","15013","14231","101.12","嘉義縣"
"233"," 大林鎮","21","317","11396","32917","16918","15999","101.12","嘉義縣"
"234"," 民雄鄉","28","522","23498","72286","37092","35194","101.12","嘉義縣"
"235"," 溪口鄉","14","205","5444","15823","8442","7381","101.12","嘉義縣"
"236"," 新港鄉","23","380","10496","33830","17853","15977","101.12","嘉義縣"
"237"," 六腳鄉","25","328","9132","25356","13451","11905","101.12","嘉義縣"
"238"," 東石鄉","23","357","9504","26713","14198","12515","101.12","嘉義縣"
"239"," 義竹鄉","22","311","7533","20158","10474","9684","101.12","嘉義縣"
"240"," 鹿草鄉","15","255","5846","16832","9041","7791","101.12","嘉義縣"
"241"," 水上鄉","26","409","17608","51497","26599","24898","101.12","嘉義縣"
"242"," 中埔鄉","22","375","15756","47025","24496","22529","101.12","嘉義縣"
"243"," 竹崎鄉","24","407","11518","37923","20190","17733","101.12","嘉義縣"
"244"," 梅山鄉","18","200","6759","20842","11047","9795","101.12","嘉義縣"
"245"," 番路鄉","11","115","4246","12227","6661","5566","101.12","嘉義縣"
"246"," 大埔鄉","5","49","1923","4547","2384","2163","101.12","嘉義縣"
"247"," 阿里山鄉","12","78","1925","5702","3047","2655","101.12","嘉義縣"
"248"," 嘉義縣","357","5347","180652","529229","275686","253543","102.12","嘉義縣"
"249"," 太保市","18","250","11983","37023","19114","17909","102.12","嘉義縣"
"250"," 朴子市","27","414","15263","43599","22067","21532","102.12","嘉義縣"
"251"," 布袋鎮","23","375","10170","28701","14725","13976","102.12","嘉義縣"
"252"," 大林鎮","21","317","11401","32593","16714","15879","102.12","嘉義縣"
"253"," 民雄鄉","28","522","23773","72096","36911","35185","102.12","嘉義縣"
"254"," 溪口鄉","14","205","5423","15546","8269","7277","102.12","嘉義縣"
"255"," 新港鄉","23","380","10551","33507","17716","15791","102.12","嘉義縣"
"256"," 六腳鄉","25","328","9056","24947","13227","11720","102.12","嘉義縣"
"257"," 東石鄉","23","357","9455","26305","13975","12330","102.12","嘉義縣"
"258"," 義竹鄉","22","311","7564","19856","10321","9535","102.12","嘉義縣"
"259"," 鹿草鄉","15","255","5832","16652","8936","7716","102.12","嘉義縣"
"260"," 水上鄉","26","409","17769","51289","26477","24812","102.12","嘉義縣"
"261"," 中埔鄉","22","375","15916","46694","24346","22348","102.12","嘉義縣"
"262"," 竹崎鄉","24","407","11545","37372","19936","17436","102.12","嘉義縣"
"263"," 梅山鄉","18","200","6780","20576","10911","9665","102.12","嘉義縣"
"264"," 番路鄉","11","115","4296","12174","6618","5556","102.12","嘉義縣"
"265"," 大埔鄉","5","49","1940","4567","2375","2192","102.12","嘉義縣"
"266"," 阿里山鄉","12","78","1935","5732","3048","2684","102.12","嘉義縣"
"267"," 嘉義縣","357","5347","181300","524783","273324","251459","103.12","嘉義縣"
"268"," 太保市","18","250","12158","37038","19077","17961","103.12","嘉義縣"
"269"," 朴子市","27","414","15405","43250","21923","21327","103.12","嘉義縣"
"270"," 布袋鎮","23","375","10115","28423","14565","13858","103.12","嘉義縣"
"271"," 大林鎮","21","317","11389","32159","16479","15680","103.12","嘉義縣"
"272"," 民雄鄉","28","522","24041","71903","36837","35066","103.12","嘉義縣"
"273"," 溪口鄉","14","205","5435","15393","8224","7169","103.12","嘉義縣"
"274"," 新港鄉","23","380","10589","33186","17576","15610","103.12","嘉義縣"
"275"," 六腳鄉","25","328","9024","24613","13052","11561","103.12","嘉義縣"
"276"," 東石鄉","23","357","9439","26235","13921","12314","103.12","嘉義縣"
"277"," 義竹鄉","22","311","7550","19578","10177","9401","103.12","嘉義縣"
"278"," 鹿草鄉","15","255","5820","16384","8771","7613","103.12","嘉義縣"
"279"," 水上鄉","26","409","17834","50726","26176","24550","103.12","嘉義縣"
"280"," 中埔鄉","22","375","15945","46156","24039","22117","103.12","嘉義縣"
"281"," 竹崎鄉","24","407","11592","36924","19704","17220","103.12","嘉義縣"
"282"," 梅山鄉","18","200","6762","20304","10782","9522","103.12","嘉義縣"
"283"," 番路鄉","11","115","4304","12089","6537","5552","103.12","嘉義縣"
"284"," 大埔鄉","5","49","1943","4658","2427","2231","103.12","嘉義縣"
"285"," 阿里山鄉","12","78","1955","5764","3057","2707","103.12","嘉義縣"
"286"," 嘉義縣","357","5347","181969","519839","270681","249158","104.12","嘉義縣"
"287"," 太保市","18","250","12381","37212","19146","18066","104.12","嘉義縣"
"288"," 朴子市","27","414","15548","42956","21776","21180","104.12","嘉義縣"
"289"," 布袋鎮","23","375","10041","27954","14300","13654","104.12","嘉義縣"
"290"," 大林鎮","21","317","11378","31697","16244","15453","104.12","嘉義縣"
"291"," 民雄鄉","28","522","24391","71862","36795","35067","104.12","嘉義縣"
"292"," 溪口鄉","14","205","5387","15113","8073","7040","104.12","嘉義縣"
"293"," 新港鄉","23","380","10637","32797","17311","15486","104.12","嘉義縣"
"294"," 六腳鄉","25","328","8985","24202","12860","11342","104.12","嘉義縣"
"295"," 東石鄉","23","357","9366","25751","13653","12098","104.12","嘉義縣"
"296"," 義竹鄉","22","311","7504","19258","10011","9247","104.12","嘉義縣"
"297"," 鹿草鄉","15","255","5795","16119","8666","7453","104.12","嘉義縣"
"298"," 水上鄉","26","409","17926","50431","26054","24377","104.12","嘉義縣"
"299"," 中埔鄉","22","375","15951","45724","23776","21948","104.12","嘉義縣"
"300"," 竹崎鄉","24","407","11693","36546","19522","17024","104.12","嘉義縣"
"301"," 梅山鄉","18","200","6763","20010","10644","9366","104.12","嘉義縣"
"302"," 番路鄉","11","115","4314","11865","6416","5449","104.12","嘉義縣"
"303"," 大埔鄉","5","49","1942","4621","2408","2213","104.12","嘉義縣"
"304"," 阿里山鄉","12","78","1967","5721","3026","2695","104.12","嘉義縣"
